sentence	sentiment
用的是高速连拍	neutral
可是定焦也太小气了如果能忍受它缓慢的存储速度的话	positive
工作的时候朋友借了台给我使用了三天	neutral
对焦真的没什么优势比偏红偏假的色彩	negative
晚上拍照比较吃力操作够复杂的	negative
出来的片子更糟感觉手柄还是略小	negative
三星的一些片子	neutral
本不打算看半幅单反	neutral
手柄也太小没有闪光灯	negative
价格日本的在左右	neutral
感谢格力达俱乐部	neutral
洞妖的明显要慢于的除了没有触摸屏以外	positive
但在大光圈长焦和闪光灯上还有不足对焦速度一般	negative
速度奇慢的非常差	negative
手感操控性能画质已然全面落后但体积不小	negative
同样用测试对焦用过/系统的人绝对会受不了的触摸屏	negative
掉皮现象以及上手旧的问题已经明显改观	neutral
尤其是曝光锁定键防抖没有想像中管用	negative
试机的几点感受	neutral
能够用上像这样的对焦系统就好了	positive
但有一个最重要的问题	neutral
特别是电池舱盖因此背景的虚化不足	positive
这头的对焦环色彩的话	negative
弱光环境下以及夜景闪光灯模式	neutral
看上去没有原来的两个盖简洁	neutral
结果对焦和色彩让人失望白平衡只能菜单调	negative
对焦的确非常非常慢但在基本的锐利度表现	negative
虽然看上去专业了	neutral
档的超级功能木有了就一姐夫机的大小	negative
缺点	neutral
最明显的例子就是	neutral
屏幕真的很舒服	positive
肤色偏金黄色外盖分成了三部分	positive
虽被它的美景深深震撼	neutral
对焦的确非常非常慢系列的画质一般	positive
还有对高反差场景的宽容	neutral
光线暗的时候对焦拉风箱照远景效果比许多机子差	negative
这是个大倍率的镜头	neutral
有些类似于与的混合体	neutral
存取慢对焦慢	positive
而是克	neutral
手动对焦有寸万象素的液晶屏有点落伍了	negative
对焦太慢了按键按起来啪啪响	positive
但却够用	neutral
快门延时稍长没有确实有点影响出片率	positive
洞妖一共有四种对焦模式	neutral
同时透露一下香港价格	neutral
虽说画质在中端机算佼佼者	positive
根据几天下来的实拍	neutral
当然这也许是白平衡的问题因为之前的的画质堪称垃圾	positive
像素密度太密了左侧的接口布局有了改变	negative
肩屏小了些的工业设计真是倒退了三十年	negative
各种暗斑彩纹就很恼人了	neutral
只是控制和手感恐怕没有这么舒服机内软件可能有问题	negative
外形设计真的很成功	positive
玩了半年就出掉了主要是边缘成像太差色散严重长焦端光圈显得小了些	positive
基本拍不了车龙	neutral
连续拍摄我试过张以内没有卡顿现象储存红灯一直亮着不影响拍摄	positive
就是成像似乎不像是微单的水平且目前售价也略高	positive
底感差外观既没有时尚	negative
同样用测试对焦但是阳光下的远景分辨率说句不好听的就像手机拍的一样而且紫边也不小	positive
如果再放宽一点要求	neutral
你几乎无法区分和	neutral
最近看到论坛上很多摄友对于的嗤之以鼻	neutral
先说下该机的缺点吧	neutral
还请大家多多指教	neutral
缺点是体积略大外观既没有时尚	negative
最终打算入手了	neutral
只不过应该会耗费不少电力吧	negative
缺点是体积略大我觉得的机身手感很不理想	positive
当然拍完视频后那是比拍照片更加漫长的存储等待时间	neutral
像素密度太密了肩屏显示的信息很多	positive
的镜头也不例外	neutral
缺点万恶的设计师脑袋是有毛病的	neutral
它相机里电池自行放电由来已久机器内闪只有	positive
才能真正用心	neutral
一些常用设置	neutral
新入小黑杂拍几张谈谈感受	neutral
屏幕用这么差的材料	negative
操做感什么的	neutral
价钱不算低但色彩略差于	positive
对焦的速度上并不是很突出六的手动对焦环是假的是对焦环不是变焦环它的手动变焦环很爽	positive
对于新上手的用户来说还是很有作用的	neutral
对焦慢的感光度在的时候也只能说勉强凑合看	negative
艺术效果拍摄时拖尾严重图像很硬	positive
操作的时候小里小气的微距自动对焦较慢	negative
一直很喜欢它的锐利度色泽与对焦速度	positive
一是太小完全不像是消费专业级数码相机的水平电池使用寿命短不过该机器已经设计了外接电源的线孔	positive
长焦是必须的	neutral
因为并不是毫无办法	neutral
原因我不知道	neutral
做工绝对体现的深厚功力	positive
机身手感一般就是不太方便	positive
先唠叨这么多吧	neutral
闪光灯没有闪光灯录像按钮	negative
现在多出来的锁定键做的太	negative
的都好设置的	neutral
具体的请参看前文的镜头介绍	neutral
在网上大家也吵得不可开交	neutral
机身塑料感强轻白平衡只能菜单调	positive
稍逊于单反的机械性能说明他的电子设计和技术较低端	negative
玩了半年就出掉了主要是边缘成像太差色散严重机身塑料感强轻	positive
这和相机的处理器	neutral
在本论坛和无忌都发过开箱作业	neutral
液晶屏回放效果有点艳丽	positive
但是外挂电源毕竟影会影响的便携性小黑虽然部分焦段锐度跟不上	negative
手动对焦有但我没有在包装里面找到高清视频线	negative
不过自己拿脚趾头想想就知道一手揣着	neutral
操作的时候小里小气的真是台强制我不要乱按快门的好机器啊	positive
但照得一塌糊涂	neutral
红圈头除了型号多	neutral
主要是高清视频录制清晰度差对焦的速度上并不是很突出	negative
摆出的机器有真心神机啊	neutral
调回后也就这样了	neutral
只是控制和手感恐怕没有这么舒服感受在对焦的时候有些犹豫	negative
画面也惨不忍睹	negative
这点额外的福利也挺不错	neutral
因为经常看到有人说的声音一塌糊涂完全没有发挥半透镜优势的对焦张/秒的连拍速度	negative
以致于的超长焦加增距后在上没法自动对焦了	neutral
的手感虽然少了的厚重感最大的问题是为小体积而小体积	positive
但是便携性较差只是开电池舱盖和卡舱盖的时候能明显感觉到塑料的做工	positive
中间会有停顿	neutral
主要是背照式	neutral
快门触感变深而且很象没有录像	positive
微距自动对焦较慢目前看感觉照片效果不如上周买的的松下	negative
强标准弱	neutral
可喜的是	neutral
补充说明	neutral
价格也最高	negative
由于没有找到官方说明	neutral
的遮光罩为什么总是做的很松键位设置不如全副方便	negative
不多说	neutral
感觉做工方面远胜	positive
我就把相机收进包里了	neutral
感觉差不多	neutral
液晶屏像素太低手柄突出部分和镜头对焦环之间的空间挤了点	negative
其实拨杆真的很好用	positive
切机身严防磕碰用转接要好很多但又没有了自动对焦	positive
结果对焦和色彩让人失望几个小按钮的感觉也是如此	negative
键位设置不如全副方便	negative
色彩太假我手持拍摄的出片率较低	positive
就说下设计上的不足	negative
但近期不打算入手	neutral
有点墨迹的感觉额	neutral
还有就是开关位置附近感觉有旷量	neutral
问题是体积也没见小啊对焦精度太差了	positive
但天空基本没有过曝	neutral
色彩感觉没有原来的容易调整那感觉和效果是脚底抹油也赶不上	positive
我又以单机身价格买进	neutral
后来熟悉后就发现的按键设置的还是比较合理的	positive
别说绝对完美	neutral
测试快门无坏点	neutral
因为机器比较小	neutral
就是对焦前先来回抽一下让人蛋疼切机身严防磕碰	positive
户外旅游和日常工作记录	neutral
夜景手持真的很吃力	negative
虽然在强度上有些降低试过边缘对焦	negative
微距自动对焦较慢就是快门声音不怎么样	negative
就只是怪的色彩	negative
可是它的机械性能又实在是不好	negative
总的感觉还是相当不错	neutral
还有使用的三款镜头与可以使用	neutral
风景摄影表现一般外观既没有时尚	positive
而是采用了一样的设计	neutral
这台相机	neutral
这次就重点玩和了	neutral
高感不好机身塑料感强轻	negative
原来单反机身的合焦提示	neutral
反正一般不会对不了焦	neutral
色彩灰暗奥巴的/镜头也是个大块头	negative
一块电池可以拍到张以上	neutral
为了能让骚尼能引起重视	neutral
机身质感佳	positive
二是尽量别逆光甚至侧光拍树木	neutral
给人的感受是觉得机器迟钝了一点	neutral
机身塑料感十足如果能有对焦微调	positive
不过我没有去过高寒地区	neutral
十分扎实	neutral
我最不满意的是那个删除键感觉机身的自动白平衡有点问题	negative
>>>	neutral
基本打算换门了	neutral
高感有说不如的目测对焦速度慢于	negative
塑料感强左侧的接口布局有了改变	negative
不会产生磨光的情况	neutral
切换成后能看到一个明亮的大大的对焦框很有旁轴机拍照的感觉	neutral
每次拍摄前	neutral
只不过应该会耗费不少电力吧我的就是最小的暗部噪点也清晰可见	negative
目前看感觉照片效果不如上周买的的松下只是控制和手感恐怕没有这么舒服	negative
目前还没有配的既小巧又足够强大的闪光灯但那对焦速度我是受够了	positive
主要是高清视频录制清晰度差窃以为还是的软件功底差了	negative
色彩不够鲜艳但实际试用发现对焦迟滞太严重	negative
液晶屏无法关闭盲拍但是感觉跟还是有一定差距的	negative
看了一些朋友的帖子	neutral
操作	neutral
可谓全方位的升级	neutral
为什么照片这么小	negative
不如做工好用过/系统的人绝对会受不了的触摸屏	positive
本人手属于比较大的单手能抓篮球	neutral
就是格式照片有点偏大本人用寸笔记本奥巴的机器握感都不好	positive
张张准确	neutral
我的就是最小的暗部噪点也清晰可见和的高感成像质量相比较而言就有些惨了	negative
原图自己电脑上看很清楚	neutral
它相机里电池自行放电由来已久总的来说用来拍人像肤色怪怪的	negative
不过就短暂体验得出的的总体表现来说	neutral
感觉夜景拍摄也很不错	positive
反差较小时镜头还会拉风箱	negative
档的超级功能木有了就是色彩比较淡	positive
这机的性价比可以说得上极高的了	positive
连续自动对焦的速度是最差的虽然在强度上有些降低	negative
这无疑在一定程度上提高了该机的便携性	positive
正好发挥了特点	neutral
价格相对昂贵当然这也许是白平衡的问题	positive
机器有双波轮	neutral
我说说我个人的看法吧	neutral
是抱着复古	neutral
但我买这机就准备了玩手动头	neutral
相隔十年购进了	neutral
出来的片子更糟对焦太慢了	negative
现在多出来的锁定键做的太没有确实有点影响出片率	negative
几个小按钮的感觉也是如此对焦速度是目前单电系统软肋	negative
要降低售价就得降低成本	neutral
但是多年的经验告诉我	neutral
白平衡只能菜单调	negative
最喜欢换镜头时封闭的设计	positive
其实相机比镜头稍重一些用起来会更趁手	neutral
质量还不如以前的用转接要好很多但又没有了自动对焦	negative
最大的问题是为小体积而小体积	negative
完全没有发挥半透镜优势的对焦张/秒的连拍速度画质偏软	negative
我估计淘宝水货应该在元左右	neutral
人像肤色微单中可以算是无敌的	neutral
一查那种是元	neutral
没什么用处就一姐夫机的大小	negative
即使顺光	neutral
应选择适合自己有长远的前途的系统	neutral
做工一般只是控制和手感恐怕没有这么舒服	positive
机器到手熟悉了一下	neutral
外拍时会以主打	neutral
色彩灰暗微距自动对焦较慢	negative
但可以接受	neutral
仅此而已	neutral
档有问题用转接要好很多但又没有了自动对焦	positive
现在谈一些个人感受与大家分享	neutral
但我没有在包装里面找到高清视频线画质没有什么出彩的地方	negative
感到出来的片子还清晰些	positive
	neutral
可是它的机械性能又实在是不好和的高感成像质量相比较而言就有些惨了	positive
小五就成打酱油的先对焦后构图速度太慢且容易焦点偏移	positive
色彩不偏差录像按钮	negative
可是看镜头和光学取景器的位置似乎也不能再小了	neutral
但整个套机拿在手里也没有向别人说的那样小	neutral
多少对目前的几款热门机有了一些体会	neutral
目前我主要使用/这只镜头作为人像之用	neutral
而且很象没有录像	negative
带来的问题就是握持感除了没有触摸屏以外	positive
同时也完全替代了翻转屏的功能	neutral
如果你手头紧	neutral
锐度偏低价格相对昂贵	positive
不过也在乘车回去的途中粗略试了一下	neutral
我个人并不是太喜欢	neutral
所以你购买的时候可以直接拿一个套机	neutral
带来的问题就是握持感防抖没有想像中管用	negative
人脸识别识别率木有手机或者强夜景手持真的很吃力	negative
价钱不算低附带的解软件解出来的效果非常差	negative
相当于是和的结合体	neutral
实在太吵了	neutral
我朋友月出厂的机子也一样进灰	neutral
试过边缘对焦不过对大光比的控制方面明显不如全副	positive
感觉高感效果和宽容度不亚于原来的	positive
同样的亮度噪点和色度噪点	neutral
而的握感有种让我很放心的感觉	positive
切换可以看到全部选项	neutral
两者的差别可能不是很大	neutral
拍出来的照片色调有些奇怪就是成像似乎不像是微单的水平	positive
操控绝对是蛮专业的	positive
转盘和那个十字大按键有些容易误操作	negative
换镜头时候请注意进灰问题	neutral
减少心里和身体的负担	neutral
城市风光	neutral
但有样机就试试吧	neutral
因此适合的拍摄范围是风光	neutral
早点不呈现聚集状态	neutral
总结	neutral
后者有些老了	neutral
但是便携性较差因为经常看到有人说的声音一塌糊涂	negative
邀请它的会员去试用	neutral
自动对焦较慢屏幕用这么差的材料	negative
难道真要节约那么几克材料吗	neutral
高感就不要太奢求了这只镜头配合起来就有点问题	negative
感觉菜单比合理	positive
所以有些片子专门用了高拍摄	positive
光圈大	neutral
握着比较舒服	neutral
奥巴的/镜头也是个大块头对焦速度慢这个完全不能和单反比啊	positive
试过大了点	neutral
表现在波轮的阻尼按钮布局以及显示屏质量等细节方面	positive
不过	neutral
价格相对昂贵操作够复杂的	negative
顺便吐槽这几个新出的镜头目前还没有配的既小巧又足够强大的闪光灯	positive
塑料感强用的时候快门声音很怪	positive
和的比似乎就少了点相位对焦点几个小按钮的感觉也是如此	positive
这是镜头太水的原因速度奇慢	positive
的遮光罩为什么总是做的很松	negative
可能握持上不是太舒服的对焦	positive
镜头方面也有不足的地方自动对焦较慢	negative
我认为这不是缺点	neutral
带着这个机器	neutral
的退市缺货	neutral
特别是拍摄人像时表现的肤色保持了一贯讨人喜欢的格调	positive
底感差但在基本的锐利度表现	positive
玩了半年就出掉了主要是边缘成像太差色散严重比偏红偏假的色彩	positive
就是我觉得把闪光灯的位置如果让给取景器更好	neutral
机身方面	neutral
没有内闪色彩不偏差	positive
但是长焦是外变焦电池续航能力一般	positive
大而通透的镜头实在是很帅	positive
快门很轻	positive
很麻烦	neutral
本人手比较大	neutral
片子发暗种种现象画面颗粒感较强	negative
暗部对焦拉风箱不过手感一般	negative
之后就是缺点了	neutral
电池使用寿命短不过该机器已经设计了外接电源的线孔操作够复杂的	negative
一个小姑娘	neutral
在了解其对焦性能后	neutral
个人使用感受	neutral
反差较小时镜头还会拉风箱格式连拍坑爹	negative
洞妖的平均只有	neutral
难怪很多买了的人都叫爽	neutral
快门速度光圈和感光度等都可手动精确设置	neutral
接下来就是痛苦的感受了	neutral
对焦精度太差了像素密度太密了	positive
既可以享受更换镜头的乐趣	neutral
啥时骚尼把这些不足改正改进了这些不足	neutral
目前看感觉照片效果不如上周买的的松下速度奇慢	positive
因此一切都是按机身默认拍摄的	neutral
机身操作	neutral
这元就是全属机身	neutral
经能把合焦点放到眼睛上	neutral
这机子分大陆版和世界各地版	neutral
塑料前脸仍然没有升级成合金材料出来的片子更糟	positive
所有的宣传照片	neutral
拍女儿	neutral
重量的减小	neutral
在暗处对焦边缘对焦点无力也是如此的设计	positive
毕竟是定焦	neutral
价格相较多出来的部分去换/的快门和个对焦点并不值得	neutral
锐度也可以接受	positive
导致机器和三脚架快装板之间的摩擦力小	neutral
也是如此的设计画面颗粒感较强	negative
而且只敢用中心对焦点	neutral
的对焦屏比较简单的感觉	negative
个人猜测原因有三:	neutral
最近对焦距离也越远	neutral
我平时一般用光圈优先	neutral
首先说明下	neutral
很厚道	neutral
相对上代产品来说	neutral
不同对焦模式有所标识	neutral
也是如此的设计这是镜头太水的原因	negative
在暗处对焦边缘对焦点无力色彩灰暗	positive
比如储存卡用的卡的价格是元	neutral
下面还是说说它的出色之处吧	neutral
我手持拍摄的出片率较低但我宁可这样也不要糟糕的做工	negative
不一样了	neutral
除非拍微距	neutral
总体上给我的感觉这套系统对焦性能和差不多电池使用寿命短不过该机器已经设计了外接电源的线孔	negative
对焦速度慢但对色彩的处理还不如众老厂经验丰富	positive
这也是我先上了的重要原因之一	neutral
只有从机顶看觉得造型怪异些快门声在体验时最想让我吐槽的就是它的快门声了	negative
最烦人的是不能全时手动快门声在体验时最想让我吐槽的就是它的快门声了	negative
但是似乎盖不严格	neutral
本来一直没有打算买的	neutral
也可以收到好的效果	neutral
我估计她都分不出和拍的照片有啥区别	neutral
我发现的色彩非常干拍出来的照片色调有些奇怪	positive
不过与相比的机身确实短了一些从左到右方向机械快门线的确蛋疼	negative
现在个月了	neutral
对焦速度很快这个与其定位相符	positive
没有功能说明他的电子设计和技术较低端	positive
取景器切换时候会有遮挡无摄像功能	negative
屏幕用这么差的材料长焦端没有防震	negative
上周试了一次机	neutral
补充一点	neutral
会更少的浪费钱	neutral
比雷克莎的便宜很多	neutral
只不过应该会耗费不少电力吧没有任何提示和显示	positive
是时候总结一下了	neutral
只是属于最严重的一类除了价格比较高一些	positive
第三层	neutral
电池续航能力很强	positive
如果你连续拍	neutral
试过薯片///	neutral
没有机内除尘是个问题但在大光圈长焦和闪光灯上还有不足	positive
就不妄加评论	neutral
谁都希望以最低的价格拿到最好的东西	neutral
口径做大一点点	neutral
现在这个样子怎么看怎么像镜头长倒过来似的	negative
非常的人性化	neutral
但是对上的都比较准确	neutral
但因为绿屏问题实在让我觉得膈应就是的色散比重引起的	positive
以前很多人都说的机身差此头焦外绿边十分严重	negative
的对比对焦显然没有的相位对焦快整体感觉就是一入门机的样子	negative
还好一般足够了	neutral
就算到的情况下缩小图还是有不错的实用性	positive
就是成像似乎不像是微单的水平可是定焦也太小气了	positive
一些印象	neutral
有不少片子都是高下拍摄的	neutral
下面是我拼装好以后的效果	neutral
机身右上多了的标志	neutral
这下有地方使唤了	neutral
和的高感成像质量相比较而言就有些惨了其实松下除了画质外	negative
人像就慢了	neutral
如果能有对焦微调存储速度慢	positive
正面太滑我觉得的机身手感很不理想	positive
这景深伤不起快门声音真心不好听	negative
白平衡简直就是一模一样	neutral
现在价格很好	neutral
还在熟悉中	neutral
我一般不用闪光灯	neutral
对于画质这方面	neutral
之前	neutral
调整曝光组合时的操控性自然不错	positive
相对于的超高像素	neutral
近日	neutral
不过对大光比的控制方面明显不如全副高感有说不如的	negative
微单用过	neutral
那买小	neutral
肤色偏金黄色奥巴的机器握感都不好	positive
个头不小	neutral
而且这种东西自己清理或者送售后都比较方便	neutral
这个太无敌了	neutral
楼下随便拍了几张	neutral
其它什么对焦很快什么的不关我事	neutral
进就进吧	neutral
首先说说机身	neutral
镜头原以为直接重新买个腾龙的头就可以了以前用下来觉得锐度背景相当好	neutral
有人说能看到镜头	neutral
拇指位置的两个多功能键不再兼顾图像回放的缩放功能	neutral
镜头突出很多操作够复杂的	negative
但实际功能很实用	positive
结果对焦和色彩让人失望	negative
对焦点有点集中没有多次曝光功能	positive
首先继承了系列相机的一贯优点小巧	neutral
也许铁丝看惯了	neutral
接图的效果也不如就只是怪的色彩	positive
而且定价太高了我的就是最小的暗部噪点也清晰可见	negative
	neutral
因为在更多的细节率的情况下	neutral
但实际试用发现对焦迟滞太严重炒冷饭	positive
肤色偏黄拍出人物的皮肤较硬	positive
镜头方面也有不足的地方照远景效果比许多机子差	negative
太方便了	neutral
的确的背景虚化不太好做没有防水防尘	positive
我认为这款机是完美的	neutral
但我却很喜欢真实的色彩就是的色散比重引起的	negative
再看后来出现的哈苏	neutral
因为经常看到有人说的声音一塌糊涂对焦慢	negative
听起来有点不爽	neutral
不愧是做家电出身的	neutral
大部分都是鲜艳模式直出	neutral
下图因当晚风大机器不稳清晰度有些受影响	neutral
色彩灰暗和的高感成像质量相比较而言就有些惨了	positive
所以出行的话	neutral
没有内闪屏幕太破了	positive
正面太滑且目前售价也略高	positive
机身	neutral
机背液晶屏竟然是塑料的高感就不要太奢求了	positive
对焦框不会显示但在自动对焦操控感受上还存在一定差距	negative
可以说罕有敌手	neutral
但由于机身比稍大	neutral
奇了怪了	neutral
合焦精准	positive
跟全开都能对上	neutral
哪里需要拨轮	neutral
操作系统反映速度很慢整体感觉就是一入门机的样子	negative
照片成象色泽自然柔和	positive
我觉得可能会好点	neutral
还可以在录制视频的同时更改对焦点	neutral
白平衡同样快门速度	negative
存取慢附带的解软件解出来的效果非常差	positive
我想说明一下	neutral
不过具体还要看个人的标准而定	neutral
使用的卡的至少要多	neutral
和开头的机器甚至开头的机器都不相符的塑料卡口明显敌不过	negative
任何题材能胜任	neutral
液晶屏像素太低但是强劲的机能会弥补画质的不足	positive
对这个屏幕回放看照片的效果也是完全能接受的	neutral
如果我用的/	neutral
其实个人感觉左一串	neutral
用电子取景器有镜头感方便构图省电	neutral
机内测光容易出错导致过曝手动对焦更慢一些	negative
但实际试用发现对焦迟滞太严重的对焦	positive
/的快门大家都非常郁闷	negative
不过买的人也少	neutral
端畸变较大	neutral
手感不错	positive
快门打到尽然有重影但是感觉跟还是有一定差距的	positive
但是屏幕实在不堪入目操作系统反映速度很慢	negative
没有防水防尘的手感虽然少了的厚重感	positive
一直对手机照相摄像不感冒的我第一次被吸引住	neutral
试机感想	neutral
整体操作来看	positive
最佳的集成化	positive
跟有了变化	neutral
操控对焦都很给力虽然有的镜头个对焦点不能都发挥作用但是也很好了	positive
特别是户外旅游中	neutral
就一姐夫机的大小画面颗粒感较强	negative
就是成像似乎不像是微单的水平除了价格比较高一些	negative
这种帖子一定不乏楼主傻做梦去吧自己造一台之类的回复吧	neutral
的遮光罩为什么总是做的很松软件不太好使	positive
随时你都可以把它戴在身边	neutral
成像属于最好的一类	positive
虽说不太认同感动家的机身设计存取慢	negative
电子取景器感觉不到任何时滞	positive
左侧的接口布局有了改变不过对大光比的控制方面明显不如全副	negative
加小痰盂基本迅速一次到位	neutral
这头的对焦环	negative
不知能拍多少张	neutral
至少我现在只有一个是这样	neutral
功能不如直出太差了	negative
而且很象没有录像塑料前脸仍然没有升级成合金材料	negative
快门触感变深但对色彩的处理还不如众老厂经验丰富	negative
基本上能录到比较满意的高清了	neutral
要说的缺点	neutral
如果要个能扎扎实实陪着你打硬仗的家伙	neutral
因为之前的的画质堪称垃圾操作系统反映速度很慢	negative
对电子取景器还是略有不适应	neutral
致命的阳光下看不清屏幕电池续航能力一般	positive
镜头为	neutral
操作系统反映速度很慢的机身依旧采用工程塑料	negative
经常是/秒	neutral
机身里面包含了很多常用镜头的数据	neutral
屏幕增大	positive
是否已经对好焦不管	neutral
对焦框不会显示操作的时候小里小气的	negative
下班路过	neutral
还可以扩展	neutral
操作系统反映速度很慢你总感觉的倍变焦是骗人的	negative
除非挂得很好	neutral
这几年被他们折磨得快要精神分裂了	neutral
结果大吃一惊它的高感在时居然和我的差不多	positive
液晶屏里一看	neutral
真的就是系统慢了点对焦真的没什么优势	positive
高感的确惊艳	positive
绝对不会在最前端的厘米处突然收缩镜筒	neutral
有时候界面操作都会有些许延时现象	negative
顶多就是看起来专业一点	neutral
优势明显	neutral
对焦测光出片白平衡基本都后期调整	neutral
强调那么多领先的功能没有必要	neutral
本人从被偷因视频功能转到上全幅后觉得太沉因视频功能和轻巧转松下到松下因画质不好试用奥林巴斯后觉得噪点偏多而转再到	neutral
也是如此的设计且目前售价也略高	negative
还是要上系	neutral
这样的充分充电和放电操作应该在正常充放电次后再重新执行一次	neutral
操控缩水	negative
时更多	neutral
机身蒙皮磨蚀严重快门触感变深	negative
特殊的	neutral
没有反差较小时镜头还会拉风箱	negative
没什么用处	negative
先对焦后构图速度太慢且容易焦点偏移	negative
机内测光容易出错导致过曝最不满意的也就对焦系统了	positive
捏在手里的感觉便是高端和让人略带一点点虚荣	neutral
但色彩略差于其次是那个主拨盘	negative
画质	neutral
没有直出太差了	negative
不过也是微小的差距	neutral
也是丑的要死	neutral
机子挺沉的	neutral
密封不好等微距自动对焦较慢	positive
变焦感觉有点慢哦液晶屏无法关闭盲拍	negative
至少秒	neutral
转轮和八向键比较好用或许是因为我没有尝过摇杆的厉害吧	positive
一是太小完全不像是消费专业级数码相机的水平感受在对焦的时候有些犹豫	positive
吵的很	neutral
完全不习惯	neutral
但按现在的要求	neutral
某家只有一台	neutral
格式持续连拍时	neutral
感谢大家忍受浏览	neutral
但是阳光下的远景分辨率说句不好听的就像手机拍的一样而且紫边也不小目前价位还是高于的	positive
简单后期照片导出时还是很慢电池太渣	negative
这是我没想到的	neutral
和差了几档	neutral
在这点上	neutral
最惨的是	neutral
欢迎交流	neutral
但是长焦是外变焦的非常差	positive
并且可以往下扩展到	neutral
比如白平衡没有显示对对焦点的明暗反差要求比较高	positive
我还是喜欢单反	neutral
另三个机器都差不多	neutral
有个模特美眉供摄友拍摄	neutral
这货跟工作电流也是直接关系的	neutral
配置一般肤色偏黄	positive
看着取景器里的对焦点从模糊清晰模糊清晰的过程的确有砸机冲动的噪点属于比较大色斑	negative
价格换算后为	neutral
我们用与其相比是不现实的	neutral
至少我本人真没觉得怎么样	neutral
也是如此的设计还有就是确实存在严重的屏偏绿的问题	negative
然后依靠拙劣的或光影魔术技术后期对照片进行一番美化	neutral
快门声确实像玩家说过的那样	positive
而腾龙出片我个人感觉比较像一个数码记录图像	negative
长焦端没有防震画质没有什么出彩的地方	negative
我基本上能接受	neutral
色彩不正及过渡不好的对焦屏比较简单的感觉	positive
的对比对焦显然没有的相位对焦快但是强劲的机能会弥补画质的不足	negative
大大提升了相机使用寿命	positive
这个家里领导很喜欢	neutral
我玩很久的	neutral
没有	negative
价格贵不少的对焦屏比较简单的感觉	negative
再看新拍的照片也没有之前的重影了	neutral
一直期望拿到一部得心应手的机子	neutral
外观变丑了画质偏软	positive
对焦叽叽的叫声让你觉得随时要坏也有紫边	negative
对于有人说它是塑料机身没有内闪	negative
的解像度可能很高	positive
长焦端光圈显得小了些暂时还不够丰富的系统	negative
最终还是听人劝吃饱饭	neutral
操作起来问题不大	neutral
色彩灰暗一是太小完全不像是消费专业级数码相机的水平	positive
正面太滑我最不满意的是那个删除键	negative
只是控制和手感恐怕没有这么舒服和的高感成像质量相比较而言就有些惨了	negative
底感差没有功能	negative
在这个上边觉得应该更大胆些	neutral
我入手是从开始的	neutral
工业设计还行	positive
全副镜头在上广角损失严重	negative
感受在对焦的时候有些犹豫	negative
我以前在小五上用都木有感受过	neutral
还是和拍摄的设置要不一样一点啊	neutral
结果对焦和色彩让人失望玩了半年就出掉了主要是边缘成像太差色散严重	negative
而且使用速度狂慢我用的是苹果一体机的对焦	negative
其次处理器的使用	neutral
机内可调整选项不少	neutral
致命的阳光下看不清屏幕液晶屏无法关闭盲拍	positive
另外还有一个的定焦镜头	neutral
和的高感成像质量相比较而言就有些惨了在肩屏的信息显示量上也不够丰富	negative
中端机型惯用的回放放大操作有了较大的改变	neutral
的两大缺点该怎么拯救	neutral
打开那个功能后	neutral
我想到一个问题头应该也有相同的问题吧	neutral
机身倒是苗条	neutral
首先是那个和啤酒瓶子盖一样的模式转盘发现对焦速度有所降低	positive
感动的操作不熟悉	neutral
万像素的照片最精细才不到	neutral
这是镜头太水的原因似乎码率不够	positive
甚至快门声音都会影响到你的创作过程从而对摄影作品产生直接的影响	neutral
感觉开关拧到距离过长就是紫边太严重	positive
但对于新手确实是很实用和好玩的功能	neutral
就是不太方便	negative
且目前售价也略高但我却很喜欢真实的色彩	negative
细节较多画面也惨不忍睹	negative
还有那个	neutral
对焦的速度上并不是很突出人脸识别识别率木有手机或者强	positive
的噪点控制比要好	positive
就一档么	neutral
自动对焦较慢说明他的电子设计和技术较低端	positive
蛋疼的紧	neutral
这样的设计也挺合理	positive
片子发暗种种现象用的时候快门声音很怪	negative
在这个选项上有三个	neutral
小黑虽然部分焦段锐度跟不上对焦叽叽的叫声让你觉得随时要坏	negative
问题是体积也没见小啊	negative
但是长焦是外变焦感觉手柄还是略小	negative
虽然不如那么专业	neutral
加上机身是全画幅的	positive
机身轻小后的缺陷装个都觉得头重脚轻比如确实有一定的进灰问题	positive
不知道是显示问题还是什么问题好少啊	neutral
或者买单反就是为了拍自己女友老婆家人	neutral
的工业设计真是倒退了三十年	negative
二是体型偏大了所以让人感觉塑料感稍重	negative
变焦感觉有点慢哦没什么用处	negative
电子取景器有时滞六的手动对焦环是假的是对焦环不是变焦环它的手动变焦环很爽	negative
那用数据线连接相机	neutral
色彩的话说明他的电子设计和技术较低端	positive
比如自己的小孩的朋友可以考虑买的和	neutral
我发现的色彩非常干四没有防抖	positive
很多人也吐槽为什么不用全金属	neutral
只是控制和手感恐怕没有这么舒服连续自动对焦的速度是最差的	negative
一个原配的电池已经够用了	neutral
也许不久的将来可以通过固件就能升级	neutral
本以为系列很难超越了	neutral
这种机器看来够我用个年了	neutral
感觉的操作习惯和的正好相反	neutral
片子发暗种种现象	negative
标准套机手感还行	positive
完全没有发挥半透镜优势的对焦张/秒的连拍速度	negative
至于有没有必要	neutral
片子发暗种种现象密封不好等	positive
对焦点有点集中无摄像功能	positive
想给他照点照片	neutral
可翻转英寸万像素液晶屏	neutral
充满后张	neutral
色彩不正及过渡不好外盖分成了三部分	positive
出来后我是成都第一批购买的	neutral
施主你咋么看	neutral
觉得电池续航能力很一般	negative
恐怕就要使用中灰镜了	neutral
绝对没有拿的那种荣耀感	neutral
头做工扎实	neutral
保证室内拍摄的效果可以类似慢同步一般的	neutral
颜色挺鲜艳的	positive
可是定焦也太小气了	negative
其次是对焦点的选择	neutral
有可能是的	neutral
档的超级功能木有了	negative
原来宾得测光的软肋	neutral
经过简单的试用	neutral
你可以轻易用手动镜头拍摄锐利的片子附加测光更加准确的帮助	neutral
炒冷饭的工业设计真是倒退了三十年	negative
对于风景爱好者不错	neutral
就是一台没有电话功能其次是那个主拨盘	positive
不过对大光比的控制方面明显不如全副软件不太好使	negative
的图缩到就基本看不到了	neutral
不过摄影爱好者似乎并不怎么买著名设计师的账	neutral
它的原配电池只有	positive
高感性能强大	positive
我觉得也不错	neutral
只是不能回放	neutral
建议还是买	neutral
毕竟也老了	neutral
软件不太好使	negative
关于关注和争议颇多的个对焦点问题	neutral
屏幕太破了价格对我来说也贵了	positive
而腾龙出片我个人感觉比较像一个数码记录图像个人觉得做工不如	negative
最喜欢和可赞的是他的操作性	positive
没有拿着那种优越感了	neutral
高感就不要太奢求了有时候界面操作都会有些许延时现象	positive
档案算蛮小的风景摄影表现一般	negative
不过手感一般而且很象没有录像	positive
半按快门锁定	neutral
中庸的色彩和较小的反差度的照片风格适合绝大多数人的口味	positive
可能我就会更加容易找到自己的定位	neutral
尤其是机背设计的改变	neutral
玩过的小机器里面感觉成像最好的还是的系列	positive
至少比一系好看	neutral
又能拍多少张	neutral
操作系统反映速度很慢	negative
每个机型上市	neutral
窃以为还是的软件功底差了目前价位还是高于的	negative
的无论是对焦速度暗部对焦能力还是合焦成功率	positive
奥巴的机器握感都不好	negative
不讨眼球	neutral
小黑虽然部分焦段锐度跟不上只是控制和手感恐怕没有这么舒服	positive
尤其是聚会或打鸟	neutral
奥巴的机器握感都不好缺点是体积略大	negative
在使用标头的情况下	neutral
画质高感低感全部都将杀得爹妈都不认识了	positive
价格也最高结果对焦和色彩让人失望	negative
整体感觉就是一入门机的样子只有一个外置接口	negative
对焦慢而且使用速度狂慢我用的是苹果一体机	positive
外形比较时尚	positive
连拍/处理器	neutral
相机设计的问题之一	neutral
松下出来的图片的比对度的确有点不够和开头的机器甚至开头的机器都不相符的塑料卡口	negative
尽管手里的玩具足够多了	neutral
说明他的电子设计和技术较低端没有功能	negative
还有一条	neutral
你总感觉的倍变焦是骗人的很多人觉得造型很怪异	positive
屏幕用这么差的材料不喜欢闪光灯的设计	negative
但是长焦是外变焦和开头的机器甚至开头的机器都不相符的塑料卡口	positive
和比好太多	neutral
感觉看不出噪点左上角的拨盘看上去仍然很幼稚	negative
虽然静音旋钮可以避免一部分按键声音录到视频里	neutral
加上色散重	neutral
拍了一会	neutral
光圈意味着什么	positive
尤其光线好的情况下	neutral
对焦点选择不是很方便	negative
这是很多帖子没提到的问题	neutral
续航够了	positive
耗电还可以状态下	neutral
总的来说用来拍人像肤色怪怪的照远景效果比许多机子差	negative
比起的相差不大	neutral
倍的拉近感还是不错的	positive
这两点都赢三星电池其余也不差	neutral
对焦模式	neutral
一来防滑更好	neutral
机身中配不上这枚镜头	neutral
最后	neutral
进之前知道有一部才万元左右	neutral
我通常很少用到以上的光圈	neutral
画面也惨不忍睹档的超级功能木有了	negative
甚至我觉得不如那么干脆果断	neutral
便宜好用的自动镜头少	negative
可以让你充分享受摄影的乐趣	neutral
看着取景器里的对焦点从模糊清晰模糊清晰的过程的确有砸机冲动想问问为什么的照片这么小啊	positive
先对焦后构图速度太慢且容易焦点偏移虽说不太认同感动家的机身设计	negative
不是可以替代的关系	neutral
真是台强制我不要乱按快门的好机器啊有时候界面操作都会有些许延时现象	positive
都用过了	neutral
高感给人的感觉很精细	positive
景深预览键没有六的手动对焦环是假的是对焦环不是变焦环它的手动变焦环很爽	negative
做工也不错	positive
减少了/的菜单内容	neutral
洞妖的明显要慢于的如果能忍受它缓慢的存储速度的话	negative
很多时候不看说明书还真不明白其作用是什么	neutral
防抖	neutral
图像很硬真是台强制我不要乱按快门的好机器啊	positive
电池太渣开机慢大概秒以上	negative
连说明书都没有看过	neutral
就马上出清了配备	neutral
艺术效果拍摄时拖尾严重感觉看不出噪点	negative
本来是想重点看	neutral
和也是相差不多	neutral
开机慢大概秒以上的工业设计到底怎么了	positive
抓上就跑	neutral
如果在它的曲线图提示下你根据情况相应调节画面的效果会得到很大的改善	neutral
所以觉得震惊	neutral
基本没用的手感虽然少了的厚重感	positive
我最不满意的是那个删除键画面颗粒感较强	negative
我手持拍摄的出片率较低但在大光圈长焦和闪光灯上还有不足	positive
作为完成了幅大底对焦速度革命的里程碑级的机型	neutral
持握感	neutral
的电子技术确实不高不深存储速度慢	positive
显示的内容比起更详细	neutral
也是如此的设计	negative
	neutral
店里零售价格约人民币	neutral
这个怎么解决	neutral
虽然与仍有一定差距但已经比快了不少	neutral
很幸运地成为了第一批试用者	neutral
表现在波轮的阻尼按钮布局以及显示屏质量等细节方面	positive
用起来灰常舒服	neutral
直出太差了没有任何提示和显示	positive
保证画质细腻	positive
就一姐夫机的大小像素密度太密了	positive
正面太滑但是长焦是外变焦	positive
也具有类似的功能	neutral
第一感受就是脖子减负了	neutral
边缘对焦还是比较容易拉风箱我是从来不敢使用以上的感光度去拍人像的	positive
二是体型偏大了但是阳光下的远景分辨率说句不好听的就像手机拍的一样而且紫边也不小	negative
其实我想发表一下自己的看法	neutral
/的快门大家都非常郁闷松下出来的图片的比对度的确有点不够	negative
偶尔出现拉风箱的现象也是正常的	neutral
你总感觉的倍变焦是骗人的	negative
手感操控性能画质已然全面落后而且很象没有录像	negative
内闪在应急的时候对我来说太重要了哎	neutral
下面简要说说自己的感想	neutral
就像手机拍照那种声音	neutral
你必须上	neutral
但对别人也许是优点	neutral
也新增了存储方式的显示内容	neutral
玩了半年就出掉了主要是边缘成像太差色散严重	negative
因为都是在车里	neutral
最烦人的是不能全时手动画质偏软	negative
比较慢	neutral
用过/系统的人绝对会受不了的触摸屏	negative
但体积不小但在基本的锐利度表现	negative
真的就是系统慢了点全副镜头在上广角损失严重	positive
最不满意的也就对焦系统了拍出来的照片色调有些奇怪	negative
带来的问题就是握持感感觉手柄还是略小	negative
有时候界面操作都会有些许延时现象但是像素比较低现在觉得我完全不需要高像素这点下面我会解释	negative
最短是在之间	neutral
优点和缺点似乎都比较突出	neutral
现在这个样子怎么看怎么像镜头长倒过来似的不过感觉快门很涩	positive
但是也没有说强到一塌糊涂	neutral
可能握持上不是太舒服而且定价太高了	positive
色彩不够鲜艳画面颗粒感较强	negative
年我去智利百内国家公园时	neutral
体积太大也是如此的设计	positive
洞妖的压缩率大于的	neutral
机身做工	neutral
对焦烂也就算了拍出人物的皮肤较硬	negative
低感光度拍摄的图像犀利清晰层次好	positive
用的是高速卡	neutral
持续连拍时胜出	positive
电子取景器有时滞比如确实有一定的进灰问题	negative
外接闪光灯真丑真的就是系统慢了点	negative
似乎码率不够但是强劲的机能会弥补画质的不足	negative
这是镜头太水的原因就是不太方便	positive
可新机把整个上部都做得浑圆	neutral
快门声音真心不好听	negative
才是他的强项	neutral
用的时候快门声音很怪密封不好等	negative
那感觉和效果是脚底抹油也赶不上机背液晶屏竟然是塑料的	negative
大概和主流微单维持在个水平	neutral
还说是为环保	neutral
个人认为这也是优于的地方	neutral
以及蔡司镜头的标识	neutral
谈谈使用感受	neutral
就是不太方便和的比似乎就少了点相位对焦点	negative
相当不错	neutral
拨轮的设计	neutral
并做出了锯齿等	neutral
然后曝光不够的情况下才会跳到和	neutral
果断	neutral
和相比有点肉	neutral
就是快门声音不怎么样色彩不偏差	negative
是看不到照片文件的	neutral
这个细微的修改确实可以获得更好的使用感受	neutral
有时候界面操作都会有些许延时现象的手感虽然少了的厚重感	negative
脖子上挂个加就一学生不是学摄影的	neutral
镜头是	neutral
体积小图像很硬	negative
就感觉出来的片子更糟比如确实有一定的进灰问题	positive
由于工作条件的便利	neutral
就在淘宝拍了	neutral
拿当备机	neutral
近日	neutral
有时在长焦段会有拉风箱现象缺点是体积略大	negative
效果会好不少	neutral
再换成万的主流	neutral
镜头上有档	neutral
出片的成功率甚至比高	neutral
价格贵不少这是镜头太水的原因	negative
在不放大的情况下通常在多数情况下是电脑显示	neutral
反应速度快	positive
取景偷拍成功率大大提升	positive
手感操控性能画质已然全面落后感觉看不出噪点	positive
只不过应该会耗费不少电力吧转盘和那个十字大按键有些容易误操作	positive
本人是相机经销商	neutral
但结果没有什么虚的	neutral
之后的路还长	neutral
最后希望大家一如既往的多出好片	neutral
闪光灯没有闪光灯	negative
取景	neutral
能见度低使你不去照远景	neutral
拍出来白蒙蒙的对焦框不会显示	negative
直接跳过	neutral
呵呵	neutral
同样的道理	neutral
用过小五实时预览模式拍照的都知道	neutral
的手感虽然少了的厚重感色彩的话	positive
看着取景器里的对焦点从模糊清晰模糊清晰的过程的确有砸机冲动刚上手觉得操作特别困难	negative
带来的问题就是握持感机身蒙皮磨蚀严重	negative
方便拍摄	neutral
许多人说有层雾	neutral
快门触感变深同样快门速度	positive
跑焦率开始上升	neutral
重量重不少	negative
用过/系统的人绝对会受不了的触摸屏风景摄影表现一般	negative
小巧轻便在单反行列中真的不是什么优势	neutral
持机和操作手感	positive
弱光下对焦困难	neutral
就是悲剧的开始	neutral
但户外最高亮度下中午下	neutral
反映给设计部门	neutral
如果资金紧张就没必要花钱升级了	neutral
最不满意的也就对焦系统了可能握持上不是太舒服	negative
之前对焦时	neutral
比如确实有一定的进灰问题玩了半年就出掉了主要是边缘成像太差色散严重	positive
奥巴的/镜头也是个大块头这景深伤不起	negative
问题是体积也没见小啊价钱不算低	negative
就是的色散比重引起的比如白平衡没有显示	negative
目前正值	neutral
防尘不好格式连拍坑爹	positive
上传一些	neutral
的对焦屏比较简单的感觉说明他的电子设计和技术较低端	positive
因为经常看到有人说的声音一塌糊涂	negative
其余的对焦点小五就成打酱油的	negative
这个嘛	neutral
至于和这阶	neutral
就是成像似乎不像是微单的水平但那对焦速度我是受够了	negative
明显优于其他三款	neutral
是属于比较纠结的一类人	neutral
彩色暗黑开始认为因为是用的缘故	neutral
因为暂时不打算入	neutral
总之很满足了	neutral
对焦点的选择也略蛋疼没有功能	negative
尝尝鲜	neutral
有时候界面操作都会有些许延时现象几个小按钮的感觉也是如此	positive
采用了可翻转英寸万像素液晶屏显示效果出色	positive
不知道是我不会用呢	neutral
六的手动对焦环是假的是对焦环不是变焦环它的手动变焦环很爽人脸识别识别率木有手机或者强	negative
值得一赞的是的拇指手柄	positive
调整好日期和时间	neutral
精度很高	neutral
但是屏幕实在不堪入目电池使用寿命短不过该机器已经设计了外接电源的线孔	negative
是唯一的选择	neutral
机器跟不过来	neutral
录像按钮二是体型偏大了	negative
对焦速度是目前单电系统软肋	negative
但它给了我近乎完美的使用感受	positive
同样抖动时	neutral
对焦点不行啊电池使用寿命短不过该机器已经设计了外接电源的线孔	negative
和以往的相机有点不一样	neutral
个人觉得做工不如基本没用	positive
比的手感都要好	positive
刚入手	neutral
不过对大光比的控制方面明显不如全副而且很象没有录像	negative
这个很有意思也很好用	neutral
没有内闪稍逊于单反的机械性能	positive
对焦速度一般电池不够用	negative
非常赞同从可玩性来讲	neutral
一耽误构图就乱了	neutral
画质敢比	neutral
现在的按键用起来不爽机身手感一般	positive
变成电子形式的了	neutral
先后进了和/	neutral
这个结论其实很主观	neutral
自动白平衡在某些特定场合容易出錯操作的时候小里小气的	negative
然后最低只有	neutral
拍出人物的皮肤较硬和的高感成像质量相比较而言就有些惨了	positive
是在是太烂了	neutral
标准的是	neutral
但是档案比起別家来大许多	neutral
速度上比只能用的卡要快	positive
如果你手头比较宽裕	neutral
可能是由于用惯了的缘故吧	neutral
手动对焦更慢一些机器内闪只有	negative
这个头的对焦性能并不好先对焦后构图速度太慢且容易焦点偏移	positive
不过这点可能和技术有关	neutral
在英国英镑入了/	neutral
也不好逃出紫边小五就成打酱油的	negative
的机身依旧采用工程塑料	negative
也许是如今也使用了的缘故吧	neutral
缺点是体积略大色彩不正及过渡不好	negative
没什么用处边缘对焦还是比较容易拉风箱	negative
但是	neutral
初次拿到给本人的第一感觉就是轻	neutral
冰冷冰冷的	neutral
这是肯定的	neutral
也没专业的机身依旧采用工程塑料	positive
甚至有负片滤镜	neutral
支持门	positive
底感差对焦速度偏慢	positive
问题是体积也没见小啊对焦烂也就算了	negative
慢慢等我上图	neutral
举起机器的时候已经有些困难了	neutral
个对焦框太大了整体感觉就是一入门机的样子	positive
最不满意的也就对焦系统了	negative
非常不错	neutral
/附带门	neutral
这意味着	neutral
图象完全看不清楚附带的解软件解出来的效果非常差	negative
松下出来的图片的比对度的确有点不够	negative
可是想一部便携机也很久了	neutral
的在连拍的时候	positive
只有一个外置接口做工一般	positive
光线也恨关键	neutral
但实际试用发现对焦迟滞太严重	negative
的体积握起来手感还是不错的	positive
跟奥巴比各有千秋	neutral
说到镜头	neutral
对强光源的处理不好变焦感觉有点慢哦	negative
所以设计理念上不高明我的就是最小的暗部噪点也清晰可见	positive
反正我现在的的慢不会对我有太大的困扰	neutral
这也是总分只评到的原因就这样还是超过许多单反了	neutral
但是阳光下的远景分辨率说句不好听的就像手机拍的一样而且紫边也不小高感有说不如的	negative
直出太差了如果能有对焦微调	positive
全副镜头在上广角损失严重晚上拍照比较吃力	negative
是非常有前途的系统	positive
但比单反轻一截	neutral
刚上手觉得操作特别困难机背液晶屏竟然是塑料的	positive
的确的背景虚化不太好做没有内闪	negative
对焦速度还稍微跟不上觉得电池续航能力很一般	negative
和腾龙被偷	neutral
新购入柯达一台试机感想	neutral
发现各方面都不错	neutral
/的快门大家都非常郁闷也不好逃出紫边	positive
虽然在强度上有些降低功能不如	positive
简单后期照片导出时还是很慢	negative
可折叠的使得胸平取景甚至腰平取景很舒服	positive
白平衡只能菜单调夜景手持真的很吃力	positive
完全没有发挥半透镜优势的对焦张/秒的连拍速度不过对大光比的控制方面明显不如全副	negative
彻底中了单反的毒	neutral
机身蒙皮磨蚀严重防尘不好	negative
压缩比有些点现在多出来的锁定键做的太	negative
而各有款的卡	neutral
简单后期照片导出时还是很慢手感操控性能画质已然全面落后	negative
机内可以自行设定镜头焦段	neutral
机身我用过	neutral
总之用过以后会有意想不到的方便和依赖性	neutral
底部材料没有改进电子取景器有时滞	negative
上午拍到下午	neutral
开机够快	positive
携带方便	positive
同样是意大利设计师的作品	neutral
是很超值的广角镜头	positive
艺术效果拍摄时拖尾严重切机身严防磕碰	negative
电池使用寿命短不过该机器已经设计了外接电源的线孔主要是最小光圈只到	positive
可是它的机械性能又实在是不好但是阳光下的远景分辨率说句不好听的就像手机拍的一样而且紫边也不小	positive
的我一会不敢超过镜头方面也有不足的地方	positive
内置缓存较大	neutral
质量还不如以前的但体积不小	positive
电池太渣对焦速度偏慢	positive
应该很多都期待出的像素版吧	neutral
严格来讲	neutral
他用结合的次顶级单筒也能拍出解析度极高的照片	neutral
菜单详细	positive
就只是怪的色彩先对焦后构图速度太慢且容易焦点偏移	positive
单点对焦后移动相机再按快门已经来不及了	neutral
机表现尚好	neutral
然后自动为你配置出一个增亮的强度	neutral
尤其是曝光锁定键	negative
高感不好的电子技术确实不高不深	positive
左手大姆指点屏幕对焦	neutral
我发现非常容易上手	neutral
镜头素质确实无可挑剔	positive
主要是因为色散控制不好的原因先对焦后构图速度太慢且容易焦点偏移	negative
俺可以负责人的说	neutral
的对焦系统基本跟一样	neutral
但那对焦速度我是受够了全副镜头在上广角损失严重	negative
易于接近拍摄对象	neutral
这么密的小像素	negative
恨不得把扔掉	neutral
实际使用中你就会发现	neutral
高感上面	neutral
对焦距离控制很牛	positive
续航能力只能算一般	neutral
足以秒杀以前见过的相机	neutral
手动对焦更慢一些手动对焦有	positive
中央八向双十字	neutral
就是的替代品	neutral
在档选择自动既可切换到档	neutral
和还是比较细腻的	neutral
随时会误碰	neutral
屏幕变大变更清晰了	positive
外观及手感	neutral
四白平衡和颜色超准确的	positive
深圳的货	neutral
期待它有更好的表現	neutral
只是这样粗略地试用一次	neutral
比我同时拥有的松下也要好	neutral
于是红心绿脚	neutral
但是感觉跟还是有一定差距的	negative
对于我个人认为的握持感优于及之前的机器	positive
松下出来的图片的比对度的确有点不够人脸识别识别率木有手机或者强	positive
以往大项选进去再进行小项目选择的树目录菜单方式已经取消了	neutral
对焦确认功能	positive
价钱不算低	negative
新增加的功能可以轻松和智能手机或者平板电脑连接	positive
对焦快	positive
的卡片	neutral
这十年来没有买单反机身	neutral
夜景手持真的很吃力自动对焦较慢	positive
不过我知道是卖一台少一台了	neutral
俱乐部给力啊	neutral
系统是当前单反和无反系统中实现/摄像最廉价的解决方案	neutral
拍出人物的皮肤较硬机身缝隙稍大	negative
没有成功	neutral
带票	neutral
简单后期照片导出时还是很慢色彩不正及过渡不好	positive
上也是加锐提亮	neutral
像有东西卡一样	neutral
亮度还是偏低的遮光罩为什么总是做的很松	positive
另外我感觉和的差别细微	neutral
配置一般说明他的电子设计和技术较低端	positive
按键比以往产品更有触感	positive
同样	neutral
中央五个对焦点很暴力充电感觉不是很方便	negative
卡插槽足够用	positive
在这里表示感谢	neutral
比如	neutral
液晶屏无法关闭盲拍机身塑料感强轻	negative
殊不知就是这一哆嗦一下子就变得丑陋多了	neutral
但对色彩的处理还不如众老厂经验丰富系列的画质一般	negative
毕竟价位不一样	neutral
但比小五的状态强很多	neutral
呵呵	neutral
的非常差表现在取景器和想比	negative
但我没有在包装里面找到高清视频线色彩太假	positive
家里人挺喜欢	neutral
能和通用	neutral
总体感觉	neutral
六的手动对焦环是假的是对焦环不是变焦环它的手动变焦环很爽所以设计理念上不高明	positive
入选机型松下	neutral
而且配件也要便宜一些	positive
尤其是裁切时	neutral
不喜欢闪光灯的设计只是控制和手感恐怕没有这么舒服	negative
不想说了	neutral
用过/系统的人绝对会受不了的触摸屏对于有人说它是塑料机身	positive
有个光圈它就不是啦	neutral
但色彩略差于没有防水防尘	negative
二的分辨率毕竟小了万	neutral
错失很多想拍的镜头	neutral
还没一只镜头沉	positive
镜头方面也有不足的地方同样用测试对焦	positive
只要空气质量不好有灰尘时能见度	neutral
都是全开可以	neutral
噪点也不明显	positive
发现摆了个展台做展示	neutral
值回早入手的高票价	neutral
把玩了两周多	neutral
个对焦框太大了奥巴的/镜头也是个大块头	positive
单电优势项目	neutral
高感比强不少	positive
的感光度在的时候也只能说勉强凑合看这么密的小像素	negative
本人玩单反已经快三年了	neutral
和一个模子出来的	neutral
质量还不如以前的而且很象没有录像	positive
昨天入了	neutral
开机慢大概秒以上这是镜头太水的原因	positive
尽管是最新入门级机型	neutral
特别是的机子	neutral
相比较	neutral
拍人像我偏爱柔和的自然光	neutral
高感	neutral
档有问题主要是因为色散控制不好的原因	negative
现在我觉得他们说的是没有道理了	neutral
拉风箱或者直接歇菜	neutral
图片下有信息	neutral
机器的操作风格都是大同小异的．	neutral
想旅游人像兼顾的朋友有一个方案可以考虑买一个的这个也是的套机镜头	neutral
用也调不好我用也用了年多了操作还是比较熟悉的	neutral
现在这个样子怎么看怎么像镜头长倒过来似的结果对焦和色彩让人失望	positive
对焦速度并没有广告中的那么神	positive
对挺感兴趣	neutral
成功率就高很多很多	neutral
他竟二话不说给我买了套当时最新的	neutral
只是控制和手感恐怕没有这么舒服而且定价太高了	positive
没有拍出来的照片色调有些奇怪	negative
有的时候会拍摄动态人物抓拍和动态人物录像	neutral
有时候界面操作都会有些许延时现象的电子技术确实不高不深	positive
扎实细密	neutral
全铝合金的机身真是极有质感	positive
旋转环设计	neutral
广角端变形控制好	positive
新传感器带来的高清录像自动对焦是大卖点	positive
总结一下也是更正之前一些草率感觉:	neutral
图像上依然没有出现任何黑斑	neutral
使用偏好的不同	neutral
既然收购了奥巴	neutral
对操作影响并不大	neutral
求高手答疑	neutral
新一代暗处色彩丢失可能是因为噪音太大导致严重降噪抹除了颜色和的高感成像质量相比较而言就有些惨了	positive
高感优异	positive
而且最近关注了一些柯达相机资料	neutral
后边有个滚轮	neutral
对焦果断	positive
色彩灰暗肩屏小了些	negative
高感太夸张了	positive
比较杂乱	neutral
手动对焦有镜头突出很多	negative
望大家海涵	neutral
你还能奢望什么呢	neutral
外接闪光灯真丑	negative
套头成像颜色偏冷接图的效果也不如	positive
的手感虽然少了的厚重感不过感觉快门很涩	negative
暂时还不够丰富的系统外观变丑了	negative
在暗处对焦边缘对焦点无力画质偏软	negative
绿色键测光/模式自动测光这样只能用手动镜头的最大光圈拍照继续保留	positive
完全不能满足我的要求	neutral
要是你觉得自己是非常专业用户	neutral
外观专业	positive
本人很自信地把该机设置为	neutral
是感光器或的工作噪声	neutral
长焦端光圈显得小了些总的来说用来拍人像肤色怪怪的	positive
但我没有在包装里面找到高清视频线尤其是曝光锁定键	negative
优点	neutral
跟踪对焦很有趣的对焦方式	positive
因为相机一定要能让人端稳	neutral
俺对摄像功能兴趣不大不说了	neutral
没有机内除尘是个问题功能不如	negative
但是竖着拍就远没有拿时那样舒服	neutral
偶尔用一用	neutral
此头焦外绿边十分严重不满的是反映速度	negative
手动对焦有机身塑料感十足	positive
没什么钱	neutral
我可以说看过上百种机型的样片	neutral
所以价格也比水货便宜将近人民币	neutral
什么机器在仓	neutral
几乎直接可以买个全新的	neutral
机内测光容易出错导致过曝用转接要好很多但又没有了自动对焦	negative
套头成像颜色偏冷那感觉和效果是脚底抹油也赶不上	positive
做为的中端单反在机身材料上放弃了金属框架而使用了全工程塑料	neutral
和开头的机器甚至开头的机器都不相符的塑料卡口就是的色散比重引起的	positive
首先外观和按键布局	neutral
因为之前的的画质堪称垃圾一是太小完全不像是消费专业级数码相机的水平	negative
的对焦	negative
但在大光圈长焦和闪光灯上还有不足现在这个样子怎么看怎么像镜头长倒过来似的	positive
现在的屏幕裸露在外	negative
适合拍风景人像等等	neutral
转换焦点非常方便迅捷	positive
无摄像功能手动对焦更慢一些	positive
就感觉出来的片子更糟同样用测试对焦	negative
用高速卡	neutral
虽说不太认同感动家的机身设计机身蒙皮磨蚀严重	positive
我是从来不敢使用以上的感光度去拍人像的机内测光容易出错导致过曝	positive
让那些用的女士双臂平伸端着手感很差的克重物显得那么滑稽可笑没有机内除尘是个问题	negative
平时也不开防抖除非快门到/	neutral
但是用惯了像素	neutral
对焦也是和镜头有关的	neutral
还有整体的暴光度	neutral
手感确很舒坦	positive
玩了半年就出掉了主要是边缘成像太差色散严重自动白平衡在某些特定场合容易出錯	negative
无反才年不到	neutral
手动对焦有机子太小太轻	negative
这里主要分享的使用感受	neutral
中央五个对焦点很暴力价钱不算低	negative
对焦烂也就算了拍的好像蒙了一层雾	positive
我的是在网上买的	neutral
但是感觉跟还是有一定差距的除了没有触摸屏以外	positive
结果对焦和色彩让人失望首先是那个和啤酒瓶子盖一样的模式转盘	negative
我手持拍摄的出片率较低	negative
没有接图的效果也不如	positive
我也写些我的建议	neutral
所以让人感觉塑料感稍重液晶屏无法关闭盲拍	positive
与外观差不多	neutral
卡快的话	neutral
对焦远胜	positive
的使用感受	neutral
便开始不满足于套头的素质	neutral
开机速度快	positive
对焦点不行啊	negative
取消了更好	neutral
说说感受	neutral
便宜好用的自动镜头少所以设计理念上不高明	negative
有时在长焦段会有拉风箱现象对于有人说它是塑料机身	negative
没有防水防尘但便携机在图像质量上总是稍欠缺一点还有不能换镜头局限了拍摄题材	negative
出片更有照片的那种气息或者说更接近艺术品	positive
因此背景的虚化不足	negative
重燃继续烧宾得的信心	neutral
对焦框不会显示缺点是体积略大	negative
吗的同一系列的机器凭什么盒子不通用	neutral
主要是因为色散控制不好的原因松下出来的图片的比对度的确有点不够	positive
圆润的按钮其实手感很不错	positive
只是控制和手感恐怕没有这么舒服中央五个对焦点很暴力	negative
在万像素图像感应器和图像处理器的双重作用下	neutral
带来的问题就是握持感但在大光圈长焦和闪光灯上还有不足	positive
所以使用前恢复出厂原始设置是非常必要的	neutral
很多很多	neutral
的小了点	neutral
手感操控性能画质已然全面落后色彩不够鲜艳	positive
号称是数码系列里最好的	neutral
妹妹哪个更慢	neutral
可能和环境也有关	neutral
系列原来有过	neutral
现在的按键用起来不爽的工业设计到底怎么了	positive
机器内闪只有画面颗粒感较强	positive
左上角的拨盘看上去仍然很幼稚导致无法进行连续拍摄	positive
刚上手觉得操作特别困难	negative
照搬	neutral
连续自动对焦的速度是最差的可是它的机械性能又实在是不好	negative
它的功能上的确有些不足按键按起来啪啪响	negative
快门声音真心不好听价格也最高	positive
除了没有触摸屏以外色彩的话	negative
压缩比有些点对焦行程做得那么长	positive
机身塑料感强轻就只是怪的色彩	negative
的感光度在的时候也只能说勉强凑合看不过感觉快门很涩	negative
当然考虑到价钱方便现在的价格很不错	positive
但在大光圈长焦和闪光灯上还有不足	negative
个人反而更喜欢外置的	neutral
老土的中心点对焦就不说了	neutral
晚上拍照比较吃力和的比似乎就少了点相位对焦点	positive
显然摄影爱好者心中有自己对相机的固定理解	neutral
无奈出尼入佳	neutral
我最不满意的是那个删除键致命的阳光下看不清屏幕	negative
包覆性好很多	positive
昨天入手	neutral
对比之前的	neutral
特别是电池舱盖肤色偏金黄色	negative
的光圈拍人物虚化的很好	neutral
看看这都是些啥垃圾	neutral
就是色彩比较淡	negative
其画质细腻饱满明暗及色彩过渡也好于	positive
也有紫边电池太渣	positive
光线暗的时候对焦拉风箱我最不满意的是那个删除键	positive
手柄也太小中央五个对焦点很暴力	positive
从操控而言	neutral
在强一档半	positive
快门声音真心不好听而且定价太高了	negative
老用户上手的时候会有不习惯	neutral
要真实很多	neutral
又懒得去北京买	neutral
水货的狠彻底	neutral
但是多用自然可以克服	neutral
不足	neutral
格式连拍坑爹试过边缘对焦	negative
不满的是反映速度屏幕用这么差的材料	negative
我父亲去年年底买了	neutral
总的而言	neutral
哪个大哥大姐给支点招啊	neutral
对焦烂也就算了手感操控性能画质已然全面落后	positive
所以设计理念上不高明操作够复杂的	negative
其实松下除了画质外	negative
可是它的机械性能又实在是不好但驱动有点慢	negative
快门声音比我想象的大得多几个小按钮的感觉也是如此	positive
本打算购买一台数码卡片机去替换那台老旧的傻瓜胶片机	neutral
在画质的表现上	neutral
拍风景静物没问题	positive
基本上所有的电池都是会在充放几百次后	neutral
低于就算是比较合适价位了	neutral
比较离散细腻	neutral
没向杆那么直观快速	neutral
旅游什么拍生活照很不方便	neutral
我不得不说	neutral
对焦系统做了小小的升级	positive
缩图看也很不错	neutral
这景深伤不起机背液晶屏竟然是塑料的	negative
回放照片的时候还有一个好玩的功能	neutral
还有多重曝光和模式也大大方便了更多的拍摄题材	positive
质量还不如以前的可是定焦也太小气了	negative
如果真的把白平衡玩明白了	neutral
良好的高表现	positive
到底多慢	neutral
我两块电池一块原电一块品胜	neutral
对焦慢说明他的电子设计和技术较低端	negative
小痰盂松松垮垮	neutral
太小太轻的相机很难端稳	neutral
基本没用出来的片子更糟	positive
比偏红偏假的色彩自动白平衡在某些特定场合容易出錯	negative
尽量低于	neutral
而小五要迟滞好一会	neutral
还有品控问题反光板污点门人脸识别识别率木有手机或者强	negative
但是像素比较低现在觉得我完全不需要高像素这点下面我会解释但是屏幕实在不堪入目	negative
套头成像颜色偏冷而且很象没有录像	positive
没有镜头方面也有不足的地方	positive
高感表现胜出	positive
单点对焦试了几张存储速度慢	negative
说明这只镜头素质还是很高的	positive
这些模式使得照片艳丽明快	positive
无敌三价格西安行货元	neutral
如果能忍受它缓慢的存储速度的话问题是体积也没见小啊	negative
可能有人会说拍人不再像以前机那样红润了	neutral
你总感觉的倍变焦是骗人的刚上手觉得操作特别困难	negative
和的高感成像质量相比较而言就有些惨了这只镜头配合起来就有点问题	negative
目测对焦速度慢于二是体型偏大了	negative
我用一代头时	neutral
高感尚可	positive
不知别人相机是否这样	neutral
现在的按键用起来不爽档有问题	negative
而且比起原来的硬塑料	neutral
这个头的对焦性能并不好	negative
对焦精度也准确	positive
其次是那个主拨盘直出太差了	negative
其余的对焦点此头焦外绿边十分严重	negative
在肩屏的信息显示量上也不够丰富主要是因为色散控制不好的原因	positive
与相比提升不大	neutral
配长焦机身偏小塑料前脸仍然没有升级成合金材料	positive
现场拆机	neutral
新购入柯达一台	neutral
全部手持	neutral
手动功能丰富	positive
且目前售价也略高配置一般	positive
它的做工确实精湛镜头也很漂亮就是一件工艺品	positive
很多人觉得造型很怪异配置一般	positive
看多了	neutral
闪光灯就算了色彩的话	positive
肤色偏黄和的高感成像质量相比较而言就有些惨了	negative
那个时候正好工厂遭受水灾	neutral
自身科技实力财力物力强大	neutral
大家有什么想问的说出来吧	neutral
对比使用感受	neutral
使用小时后重量和体积的优势比巨大了	positive
描述比较详细	neutral
按下快门可能已成相	neutral
/的快门大家都非常郁闷不过与相比的机身确实短了一些从左到右方向	negative
我的就是最小的暗部噪点也清晰可见对焦速度是目前单电系统软肋	positive
稳定性照电子快门线和遥控器差的多此头焦外绿边十分严重	negative
它的功能上的确有些不足但那对焦速度我是受够了	positive
一开始对的按键并不熟悉	neutral
只是开电池舱盖和卡舱盖的时候能明显感觉到塑料的做工除了没有触摸屏以外	negative
有人常说摄影要用心	neutral
因此主要对比和的一些差别	neutral
套头成像颜色偏冷对焦速度慢这个完全不能和单反比啊	negative
但是外挂电源毕竟影会影响的便携性档的超级功能木有了	positive
是空气中无数灰尘产生的小紫边汇聚而成	neutral
所以设计理念上不高明对焦慢	positive
中央五个对焦点很暴力	negative
人不会带你考虑	neutral
还有摄像功能键也有了变化	neutral
但是对焦速度够快够准	positive
和功能真不错	positive
机子太小太轻操控缩水	positive
采用了工程塑料作为机身材质	neutral
机顶设置快捷键以特殊的形状出现	positive
更没人会过多关注你	neutral
纠结了一会会	neutral
机器内闪只有电池使用寿命短不过该机器已经设计了外接电源的线孔	positive
大项中有数个页面	neutral
变焦也和顺畅	positive
可能握持上不是太舒服机身塑料感十足	negative
机内软件可能有问题机器内闪只有	positive
反差大的地方合焦非常果断	neutral
六的手动对焦环是假的是对焦环不是变焦环它的手动变焦环很爽色彩不够鲜艳	negative
毕竟要花钱的地方还有很多	neutral
小五宾得是工业品	neutral
没有机内除尘是个问题	negative
因此背景的虚化不足外观既没有时尚	negative
就是对焦前先来回抽一下让人蛋疼但那对焦速度我是受够了	negative
用的时候	neutral
现在多出来的锁定键做的太而远角端只有	positive
光学防抖技术也为长焦和较低速快门下的使用提供了一定的保障	neutral
在户外可以拍到此一游照	neutral
目前手头有的老相机	neutral
如果能有对焦微调对焦慢	positive
单位要求拍各科组的合照	neutral
就感觉出来的片子更糟色彩不够鲜艳	negative
机器内闪只有	negative
金圈镀膜亮骚	neutral
当你发现你拍的照片卖不了钱的时候	neutral
就要看个人资金了	neutral
但在上面	neutral
的操作基本上都以右手为主	neutral
说说感受	neutral
其次是那个主拨盘细节较多	negative
是一款让人爱恨交加的机子	neutral
如果未来我再次换系统	neutral
转盘和那个十字大按键有些容易误操作最大的问题是为小体积而小体积	negative
而且对焦辅助功能同时存在	neutral
而且我一般都习惯用取景	neutral
顺应了部分胶片时代延续的习惯	neutral
给力的色彩	positive
如图所示	neutral
近得三星一部	neutral
的工业设计到底怎么了无摄像功能	negative
手动对焦更慢一些	negative
对焦速度慢这个完全不能和单反比啊但是强劲的机能会弥补画质的不足	positive
色彩感觉没有原来的容易调整有时候界面操作都会有些许延时现象	negative
多帧降噪真的很不错都比我的的都好	positive
本着宽打窄用的原则	neutral
艺术效果拍摄时拖尾严重没有内闪	positive
价格贵不少总的来说用来拍人像肤色怪怪的	positive
和大家交流一下	neutral
所以两者的差距不用实际使用都知道差距巨大	neutral
就只是怪的色彩镜头突出很多	positive
我发现的色彩非常干机内测光容易出错导致过曝	negative
持机和操作手感	positive
就是格式照片有点偏大本人用寸笔记本真的就是系统慢了点	positive
后问世的在这方面的努力后来居上	neutral
因为当时主要事为了出去旅游配的	neutral
这头的对焦环的遮光罩为什么总是做的很松	negative
另外金属机身应该是吧和３寸的屏幕也是我比较中意的地方．	positive
不算贵	neutral
但是拿回家在电脑上看	neutral
对焦点选择不是很方便键位设置不如全副方便	negative
和随机软件	neutral
只是控制和手感恐怕没有这么舒服没有	positive
肤色偏黄	negative
开启自然防震	neutral
今天去试用的体会	neutral
在一些光线一般的情况下仍然可以拍摄出清晰的照片	positive
单手可去掉镜头	neutral
回到摄影话题上	neutral
噪点才明显增加画质也明显下降	neutral
但是长焦是外变焦因此背景的虚化不足	positive
也肯定有一定的优势	neutral
这两天实在忍不住果断入手了	neutral
试用机身	positive
小日本做事的确细致	neutral
原目标超预算或套机	neutral
但是阳光下的远景分辨率说句不好听的就像手机拍的一样而且紫边也不小的机身依旧采用工程塑料	negative
暗角消除	neutral
切机身严防磕碰单点对焦试了几张	negative
试过边缘对焦现在的按键用起来不爽	negative
而且大多不是用中心对焦	neutral
快门声音比我想象的大得多但实际试用发现对焦迟滞太严重	negative
液晶屏无法关闭盲拍色彩太假	negative
四年前	neutral
成像上也保留了的特色	positive
但我却很喜欢真实的色彩但在基本的锐利度表现	negative
但不是无法接受的那种	neutral
不得不赞叹	neutral
机械快门线的确蛋疼就是不太方便	positive
而且优点是	neutral
但因为绿屏问题实在让我觉得膈应	negative
非常可靠	neutral
色彩不偏差现在的屏幕裸露在外	negative
是台好机器	neutral
只有一个外置接口压缩比有些点	positive
快门声音真心不好听其实松下除了画质外	positive
图象完全看不清楚不过对大光比的控制方面明显不如全副	negative
我更习惯用拍摄	neutral
我在工厂里拍工人下货的时候	neutral
自开始就如此	neutral
简单后期照片导出时还是很慢个人觉得做工不如	positive
以下一组夜景用不同的感光度拍摄的	neutral
但是的流线风格显然不比差	positive
尤其是追拍情况下	neutral
导致无法进行连续拍摄我是从来不敢使用以上的感光度去拍人像的	negative
似乎也不是多困难的事情吧	neutral
机身给人一种厚重的感觉	positive
发现对焦速度有所降低只是开电池舱盖和卡舱盖的时候能明显感觉到塑料的做工	negative
但是阳光下的远景分辨率说句不好听的就像手机拍的一样而且紫边也不小感觉看不出噪点	negative
画面也惨不忍睹且目前售价也略高	negative
四没有防抖切机身严防磕碰	positive
焦距越远	neutral
且目前售价也略高数据线都不配	negative
转盘和那个十字大按键有些容易误操作完全没有发挥半透镜优势的对焦张/秒的连拍速度	positive
所以只说它	neutral
新涂层手感也不错	positive
镜头	neutral
除了没有触摸屏以外对焦真的没什么优势	positive
对焦的确非常非常慢目前看感觉照片效果不如上周买的的松下	negative
阳光下发现镜头还真脏	neutral
最大光圈	neutral
不过你只当没有它就完了	neutral
接图的效果也不如附带的解软件解出来的效果非常差	negative
金圈下面那一节弄个那样的防滑橡胶套上	neutral
还有品控问题反光板污点门光线暗的时候对焦拉风箱	positive
比成熟	neutral
的速度对我来说简直有点性能过剩了	positive
拍的好像蒙了一层雾对焦点选择不是很方便	negative
机身缝隙稍大配长焦机身偏小	negative
除了顶级的１系列．．．	neutral
就感觉出来的片子更糟没有	negative
的确的背景虚化不太好做现在的按键用起来不爽	negative
而洞妖减少了快	neutral
光线不好时画质下降的明显	neutral
手感操控性能画质已然全面落后尤其是曝光锁定键	positive
用长焦;	neutral
除了之外	neutral
高感不好	negative
看着取景器里的对焦点从模糊清晰模糊清晰的过程的确有砸机冲动一是太小完全不像是消费专业级数码相机的水平	positive
你总感觉的倍变焦是骗人的切机身严防磕碰	positive
总体上给我的感觉这套系统对焦性能和差不多但我没有在包装里面找到高清视频线	positive
这只镜头配合起来就有点问题速度奇慢	positive
而且的噪点控制居然比强大的多	positive
镜头口有螺圈	neutral
体积太大套头成像颜色偏冷	negative
在实际使用中发现暗光近景不错有一些独特的味道	positive
档有问题你总感觉的倍变焦是骗人的	positive
手感不错	positive
手感极好可惜真是太小了是个袖珍的杀器	positive
手感操控性能画质已然全面落后无摄像功能	negative
选择焦点类似单反的焦点选择功能	neutral
的非常差表现在取景器和想比	negative
第一次看到的时候感觉很漂亮	neutral
那感觉和效果是脚底抹油也赶不上电池续航能力一般	negative
这点强小五一头了	neutral
价格贵不少快门声音真心不好听	negative
等年年中跌倒左右的时候就可以入手了	neutral
先对焦后构图速度太慢且容易焦点偏移就是的色散比重引起的	positive
机身手感一般我觉得的机身手感很不理想	negative
俺心也是痒痒的	neutral
操作系统反映速度很慢	negative
否则是没法拍照	neutral
入手便携机	neutral
封顶了	neutral
也有说比好的	neutral
真的就是系统慢了点似乎码率不够	negative
如果能有对焦微调速度奇慢	positive
如最大只有秒的暴光	neutral
在南京东路新开了一家直营店	neutral
长焦端光圈显得小了些就是快门声音不怎么样	negative
功能不如闪光灯没有闪光灯	positive
能抵几个月的掉价空间了	neutral
这样持机更稳	neutral
因为之前的的画质堪称垃圾最烦人的是不能全时手动	positive
但已经十分满足了	neutral
对此我只能劝这些摄友不要再意淫了	neutral
机内软件可能有问题	negative
感觉:	neutral
注意不是的镜头	neutral
像素密度太密了个人觉得做工不如	negative
主要是高清视频录制清晰度差广角端边缘锐度不行	negative
白平衡	negative
手柄突出部分和镜头对焦环之间的空间挤了点另外高感也差很多	positive
光线暗的时候对焦拉风箱	negative
纯粹是被宾得的小底小光圈憋坏了	neutral
档的超级功能木有了想问问为什么的照片这么小啊	negative
操控/菜单/说明书	neutral
我觉得的机身手感很不理想亮度还是偏低	positive
半按快门自动对焦后旋转对焦环机器可自动放大	neutral
图象完全看不清楚屏幕用这么差的材料	positive
天所拍的照片加起来居然没有今年故地重游不到天所拍的照片多	neutral
全点十字型自动对焦系统	neutral
上个月拿着奖学金回国买了套机	neutral
新的系统还需要花时间去适应	neutral
这机器还有好多功能我没玩明白呢．	neutral
效果高于的	positive
没有功能直接出片机内处理锐度过头了点	positive
拍出来的照片色调有些奇怪但我却很喜欢真实的色彩	negative
对对焦点的明暗反差要求比较高基本没用	negative
感觉手柄还是略小	negative
优点	neutral
到目前为止其表现堪称完美	positive
握持感很合适	positive
现在的按键用起来不爽画质没有什么出彩的地方	negative
有时候界面操作都会有些许延时现象个人觉得做工不如	negative
很多人觉得造型很怪异边缘对焦还是比较容易拉风箱	negative
但也不乏一些创新	positive
主要是因为色散控制不好的原因没有机内除尘是个问题	negative
可以插两张卡	neutral
追拍时由于相机移动	neutral
中间有大概秒左右的呆滞时间	neutral
张连拍像机关枪一样	positive
对焦点有点集中对焦的速度上并不是很突出	negative
在北方零下十几度的气温下	neutral
大小也正好	positive
结果人气很旺	positive
本人只是菜鸟	neutral
对对焦点的明暗反差要求比较高	negative
和的高感成像质量相比较而言就有些惨了致命的阳光下看不清屏幕	negative
加上內建防手震等等功能	positive
光圈全开大逆光拍摄还是有紫边	neutral
尤其是曝光锁定键手动对焦有	negative
但我宁可这样也不要糟糕的做工只是属于最严重的一类	negative
宝宝蹦蹦跳跳的照片	neutral
优势是更加轻便	neutral
在开启降噪的情况下	neutral
高感	neutral
机身缝隙稍大稍逊于单反的机械性能	negative
我是从来不敢使用以上的感光度去拍人像的但是便携性较差	negative
对于有人说它是塑料机身	negative
暂时还不够丰富的系统体积太大	positive
自动对焦能力也不错	positive
风景摄影表现一般致命的阳光下看不清屏幕	negative
搞了场旧镜头内部拍卖	neutral
虽然我以前一直认为才是牛的中端王者	neutral
各位高手如果觉得写的不对还请见谅	neutral
直出太差了软件不太好使	negative
有没哪位高人推荐款能解的软件呢	neutral
感觉在变焦的时候有些迟滞	negative
快门	neutral
支持无线引闪	neutral
十分方便	neutral
夜景是要角架支持才能出好片	neutral
也有紫边但实际试用发现对焦迟滞太严重	positive
买卡也不计较价格了	neutral
暂时还不够丰富的系统洞妖的明显要慢于的	negative
但是阳光下的远景分辨率说句不好听的就像手机拍的一样而且紫边也不小无摄像功能	negative
可是它的机械性能又实在是不好的确的背景虚化不太好做	positive
即色散	neutral
塑料感强反差较小时镜头还会拉风箱	negative
没有闪光灯而且使用速度狂慢我用的是苹果一体机	negative
新一代暗处色彩丢失可能是因为噪音太大导致严重降噪抹除了颜色也没专业	negative
目前没几个人会用	neutral
更好的保证拍摄的时候不会不小心碰到模式转盘	neutral
可以确定	neutral
接图的效果也不如问题是体积也没见小啊	negative
这景深伤不起但色彩略差于	negative
更期待能改善一些不完善	neutral
我现在特别好奇的声音到底是个什么样	neutral
原因很简单	neutral
由于本人长期在用	neutral
就是紫边太严重感觉开关拧到距离过长	negative
镜头有过至今	neutral
手感操控性能画质已然全面落后画面也惨不忍睹	negative
屏幕增大到了英寸	neutral
快门声音比我想象的大得多稍逊于单反的机械性能	negative
总结一些小小心得与色友们分享	neutral
重量重不少高感有说不如的	positive
这种情况很少	neutral
高感提高一档	positive
单点对焦试了几张但是强劲的机能会弥补画质的不足	negative
还有就是确实存在严重的屏偏绿的问题照远景效果比许多机子差	positive
还有就是	neutral
机内软件可能有问题晚上拍照比较吃力	positive
的噪点属于比较大色斑感觉看不出噪点	negative
是否是这个原因导致了将光学取景器取消了	neutral
色彩太假晚上拍照比较吃力	positive
不方便	neutral
上手感觉还是很不错的	neutral
这玩意儿是不是比原来那个重一点点	neutral
拨轮的设计	positive
实用性焦段与光圈远胜的薯片	positive
画面也惨不忍睹对焦慢	negative
快门速度	neutral
包含电池重量为克	neutral
但实际试用发现对焦迟滞太严重那感觉和效果是脚底抹油也赶不上	negative
也是如此的设计结果对焦和色彩让人失望	positive
长的很复古	neutral
也没专业但实际试用发现对焦迟滞太严重	negative
我觉得这个功能很棒	neutral
注意机子的拍照角度	neutral
连新出的也赶不上上一代产品	neutral
单点对焦试了几张压缩比有些点	negative
不如做工好个对焦框太大了	negative
对焦点的选择也略蛋疼高感有说不如的	negative
另外万像素没觉得怎么样	neutral
取景时	neutral
应该说是一台很有看点的相机	neutral
半按快门时候	neutral
成像锐利	positive
下月发布	neutral
没有任何提示和显示对焦慢	negative
体积和重量都达到了不错的平衡	positive
欢迎批评指正	neutral
色彩表现也符合我的口味	positive
哈哈我也是其中之一	neutral
的色温可以从到	neutral
没什么用处取景器切换时候会有遮挡	positive
虽然在强度上有些降低没有防水防尘	positive
系列的画质一般所以设计理念上不高明	positive
也就是相机就该有相机的样子	neutral
厦门这几天天气不好	neutral
增加以上更好饼干头加上全时手动自动放大对焦	neutral
图像很硬但我却很喜欢真实的色彩	negative
也可以依托栏杆之类的固定物	neutral
对焦烂也就算了暗部对焦拉风箱	positive
外置光学取景器	neutral
对焦速度很快	positive
前面的阻尼转圈很实在	positive
奥巴的/镜头也是个大块头还有就是确实存在严重的屏偏绿的问题	negative
都不够时间折腾呢．	neutral
我感觉的电子版说明书很好用	neutral
它的分辨率很高	positive
同样用测试对焦	negative
但是还是比没有更强	neutral
机身手感一般拍的好像蒙了一层雾	positive
呵呵．	neutral
不知道能不能装滤镜	neutral
上面链接中的照片足可以说明问题	neutral
高感也不错	positive
附带的解软件解出来的效果非常差夜景手持真的很吃力	positive
快门打到尽然有重影屏幕用这么差的材料	positive
要是有体验	neutral
机子太小太轻按键按起来啪啪响	positive
按键按起来啪啪响但我却很喜欢真实的色彩	positive
当时选就是看中这头	neutral
每秒张得连拍加上极低的快门时滞让几乎可以胜任任何题材的拍摄	positive
手动对焦时	neutral
性能貌似也不弱	positive
而且定价太高了就只是怪的色彩	negative
对焦挺准的	positive
太牛了	neutral
基本上称得上高手了	neutral
同样快门速度没有任何提示和显示	negative
景深预览键没有没有闪光灯	negative
但对色彩的处理还不如众老厂经验丰富对焦行程做得那么长	negative
不用电脑后期处理	neutral
感觉手柄还是略小有时候界面操作都会有些许延时现象	negative
所以让人感觉塑料感稍重就是格式照片有点偏大本人用寸笔记本	positive
这只镜头配上了镜头盖是好事	neutral
的确的背景虚化不太好做	negative
曝光补偿转盘	neutral
没有连到电脑看图	neutral
因为它的功能很不错	positive
虽说这点有人喜欢有人不满	neutral
每拍一张到再次能拍摄	neutral
十分推荐	neutral
不管懂还是不懂的	neutral
的对焦而远角端只有	positive
所以拿	neutral
各方面我都很满意	neutral
而且使用速度狂慢我用的是苹果一体机的噪点属于比较大色斑	positive
的手感虽然少了的厚重感真是台强制我不要乱按快门的好机器啊	negative
细腻清晰层次丰富	neutral
毕竟相机不是板砖摔来摔去	neutral
且目前售价也略高的非常差	negative
可恶和两家在镜头上很多操作是反的	neutral
拍视频也方便多了	neutral
在里是很容易拉回来的	neutral
从看	neutral
而且定价太高了现在的按键用起来不爽	positive
奥巴的/镜头也是个大块头中央五个对焦点很暴力	negative
拍出人物的皮肤较硬速度奇慢	positive
肩屏对我也没啥吸引力了	neutral
我手持拍摄的出片率较低和的高感成像质量相比较而言就有些惨了	positive
经过了很多的踌躇和忧郁	neutral
风景摄影表现一般用转接要好很多但又没有了自动对焦	positive
就是对焦前先来回抽一下让人蛋疼液晶屏像素太低	positive
第二天几乎是欠曝	neutral
功能很好玩	positive
几台样机时常要换着电源线充电	neutral
套头成像颜色偏冷对焦慢	negative
顺便去体验下	neutral
青菜萝卜的事咋能说清呢	neutral
目前看感觉照片效果不如上周买的的松下虽然在强度上有些降低	positive
都是很好的机子	neutral
只要用相同的镜头和胶片	neutral
但是阳光下的远景分辨率说句不好听的就像手机拍的一样而且紫边也不小现在的屏幕裸露在外	positive
玩了十五分钟左右	neutral
这个价位嘛	neutral
晚上拍照比较吃力	negative
但因为绿屏问题实在让我觉得膈应底感差	positive
速度奇慢配置一般	negative
操作系统反映速度很慢镜头突出很多	negative
用说明书里的术语说	neutral
昨晚到了内罗毕	neutral
的对比对焦显然没有的相位对焦快底部材料没有改进	negative
你总感觉的倍变焦是骗人的机背液晶屏竟然是塑料的	negative
长焦端光圈显得小了些软件不太好使	positive
电池使用寿命短不过该机器已经设计了外接电源的线孔闪光灯没有闪光灯	negative
机身按键基本合理	positive
最烦人的是不能全时手动感觉开关拧到距离过长	negative
机子到手也有三个月了	neutral
档的超级功能木有了数据线都不配	negative
也就造成了的噪点本质小于	neutral
由于传感器的特殊性和一起留下了	neutral
对焦烂也就算了对焦点选择不是很方便	negative
其次是那个主拨盘长焦端光圈显得小了些	positive
比准确多了	neutral
有没有遇到相同问题	neutral
与其它的机子比起来	neutral
高感还是不错的	positive
暗部对焦提升明显	positive
感觉机身的自动白平衡有点问题但驱动有点慢	positive
另外要说一点	neutral
还没看说明书	neutral
个子还没米	neutral
这个声音还是会被视频播捉到	neutral
入手两个多月	neutral
测试了一下	neutral
手感操控性能画质已然全面落后明显敌不过	positive
而远角端只有塑料前脸仍然没有升级成合金材料	negative
充电感觉不是很方便高速卡帮助不大	positive
机内软件可能有问题而且定价太高了	positive
但便携机在图像质量上总是稍欠缺一点还有不能换镜头局限了拍摄题材感受在对焦的时候有些犹豫	negative
就觉得的快门声格外的好听	positive
肩屏小了些它相机里电池自行放电由来已久	positive
电池续航能力一般对焦速度还稍微跟不上	negative
先用借只手指来对完再拍不就了嘛	neutral
据说是小五那块的改进版	neutral
最高完全可用	neutral
对焦的速度上并不是很突出存取慢	negative
操作够复杂的比如确实有一定的进灰问题	positive
如果能忍受它缓慢的存储速度的话炒冷饭	negative
其余的对焦点小五就成打酱油的	positive
就说下设计上的不足目前还没有配的既小巧又足够强大的闪光灯	negative
软件不太好使最大的问题是为小体积而小体积	positive
艺术效果拍摄时拖尾严重最不满意的也就对焦系统了	negative
我没有再去买一个闪光灯的动力	neutral
穷人买不起原厂啊	neutral
电池不够用色彩感觉没有原来的容易调整	positive
没有任何提示和显示画质没有什么出彩的地方	negative
这头全开光圈的情况下在白天一般都能达到安全快门以上	neutral
同样用测试对焦高速卡帮助不大	negative
机身轻小后的缺陷装个都觉得头重脚轻图像很硬	positive
到目前为止小心肝还在扑通扑通乱跳	neutral
大家买备机的时候也考虑一下上面的几点吧	neutral
有点大	neutral
虽不假	neutral
格式连拍坑爹风景摄影表现一般	positive
因为一直是室内拍摄	neutral
防尘不好但是阳光下的远景分辨率说句不好听的就像手机拍的一样而且紫边也不小	positive
用奶昔拍了几十张人像照	neutral
高感有说不如的镜头突出很多	negative
对强光源的处理不好但我宁可这样也不要糟糕的做工	negative
当然	neutral
首先测试的就是高感	positive
但可供选择的只有	neutral
这点我也想吐槽下	neutral
电池不够用也有紫边	negative
是难得一见的诚意之作	neutral
去年开始又用上和	neutral
只是相对	neutral
主要是最小光圈只到	negative
没有功能基本没用	negative
价格对我来说也贵了色彩感觉没有原来的容易调整	negative
问题是体积也没见小啊整体感觉就是一入门机的样子	positive
不过奥巴也非常快了	neutral
暗部对焦拉风箱对焦慢	negative
而做的机器每个特点都不一样	neutral
先这些	neutral
的感光度在的时候也只能说勉强凑合看其次是那个主拨盘	negative
机内软件可能有问题没有	positive
完全个人感受	neutral
因为经常看到有人说的声音一塌糊涂所以设计理念上不高明	negative
而且可以避免外界光线干扰观察取景器	neutral
内置外置扩展	neutral
只是控制和手感恐怕没有这么舒服现在这个样子怎么看怎么像镜头长倒过来似的	negative
旁边是一个大写的	neutral
以前很多人都说的机身差	negative
此头焦外绿边十分严重特别是电池舱盖	positive
最烦人的是不能全时手动我发现的色彩非常干	negative
虽口水红圈的色彩	neutral
拇指手柄	neutral
其次是便携	positive
伸出来的突兀的相对巨大的镜头	neutral
长焦端没有防震肤色偏金黄色	positive
基本没用做工一般	negative
理由是太小了	neutral
的高感成像质量让我惊叹	positive
这头的对焦环单点对焦试了几张	positive
不像原来那样生涩	neutral
可我对它的机身感觉确实如此	neutral
目前价位还是高于的	negative
不过视频剪辑我是小白	neutral
算是分水岭	neutral
由于连拍性能的关系	neutral
似乎码率不够微距自动对焦较慢	positive
单点对焦试了几张格式连拍坑爹	positive
外盖分成了三部分但在自动对焦操控感受上还存在一定差距	positive
因此是有功能	neutral
我常用到的就是回看图片时候的缩放操作不一样了	neutral
还是一样要用转调完后才能放心出片的	neutral
密封不好等几个小按钮的感觉也是如此	negative
再拍不出好片就怪天气	neutral
星期六日玩耍了两天	neutral
不失为一款实用且轻巧的全画副单反选择	neutral
这是台好机器	neutral
的工业设计真是倒退了三十年快门触感变深	negative
稳定性照电子快门线和遥控器差的多对焦点的选择也略蛋疼	negative
有人吐槽对焦没有用这套点系统	neutral
四没有防抖外接闪光灯真丑	negative
新一代暗处色彩丢失可能是因为噪音太大导致严重降噪抹除了颜色让那些用的女士双臂平伸端着手感很差的克重物显得那么滑稽可笑	positive
比如白平衡没有显示快门声音真心不好听	negative
第一张是曝光正常的话	neutral
另外高感也差很多机内软件可能有问题	positive
现在的清晰度很好	positive
以前基本不会超过	neutral
这大可不必	neutral
试过边缘对焦	negative
给他更好的机器只会让他的创作更加得心应手	neutral
另外高感也差很多外盖分成了三部分	negative
档案算蛮小的自动白平衡在某些特定场合容易出錯	negative
对焦速度很快	positive
成像很好	positive
还没有别人的倍拉得近	neutral
配长焦机身偏小便宜好用的自动镜头少	positive
的确难听	neutral
还很顺眼	neutral
总体上给我的感觉这套系统对焦性能和差不多但是外挂电源毕竟影会影响的便携性	positive
无货	neutral
屏幕太破了	negative
更重要是写速度而不是读速度	neutral
主要是最小光圈只到对焦速度还稍微跟不上	positive
小巧极大地提升了拍摄的欲望	neutral
连续自动对焦的速度是最差的	negative
但是感觉跟还是有一定差距的当然这也许是白平衡的问题	negative
刚好换门可以弄个焦段差不多的	neutral
暂时还不够丰富的系统风景摄影表现一般	positive
初步感受机器很沉	neutral
你看的片子比哪种相机的色彩都紫	neutral
最便宜的/摄像机	neutral
对卡并非实时存储	neutral
如果你想使用快门线也行	neutral
然后	neutral
操作够复杂的档有问题	positive
直出	neutral
的模式转盘顶部增加了锁定键	positive
左上角的拨盘看上去仍然很幼稚快门延时稍长	positive
机背液晶屏竟然是塑料的你总感觉的倍变焦是骗人的	positive
所以一直在寻求一台相对轻巧图像质量又好可以换镜头的单反	neutral
感觉在变焦的时候有些迟滞感觉手柄还是略小	negative
不过手感一般	negative
感觉在变焦的时候有些迟滞而远角端只有	negative
松下出来的图片的比对度的确有点不够新一代暗处色彩丢失可能是因为噪音太大导致严重降噪抹除了颜色	positive
调的真好	neutral
不满的是反映速度松下出来的图片的比对度的确有点不够	negative
当然它的缺点能改善就更完美了	neutral
很多人认为照片容量大	neutral
感觉拍出来还是不错的	neutral
如果调成格式	neutral
色彩浓郁透亮且锐度较高	positive
同样用角架	neutral
系列的画质一般	negative
你做的通用一下会死啊	neutral
画质方面	neutral
对焦框自由移动	positive
其余的对焦点闪光灯就算了	negative
档有问题暗部对焦拉风箱	negative
得说二者相比起来	neutral
有人说能拍张相片	neutral
感觉中心对焦的范围比小	neutral
储存过程中还可以拍摄	neutral
按键按起来啪啪响但在大光圈长焦和闪光灯上还有不足	negative
感觉手柄还是略小觉得电池续航能力很一般	positive
很火	neutral
许多功能设置有可能被试用者按自己的个人习惯改变	neutral
的电子技术确实不高不深主要是高清视频录制清晰度差	negative
但又感觉机器太大太重了	neutral
快门声在体验时最想让我吐槽的就是它的快门声了这只镜头配合起来就有点问题	negative
让那些用的女士双臂平伸端着手感很差的克重物显得那么滑稽可笑但在自动对焦操控感受上还存在一定差距	positive
有点感受	neutral
高感就不要太奢求了自动对焦较慢	negative
这个头的对焦性能并不好就是色彩比较淡	positive
强大的对焦系统	positive
晚上拍照比较吃力似乎码率不够	negative
重量体积不是负担	positive
比如白平衡没有显示价格也最高	negative
你借一个万像素在同一场景和对照	neutral
顺便说一下高速卡	neutral
额外多问各位机友一句	neutral
要充电	neutral
虽然在强度上有些降低首先是那个和啤酒瓶子盖一样的模式转盘	negative
分别是每秒张和张	neutral
粗略的测试了一下中心对焦区域的相位对焦点	neutral
对焦框不会显示存取慢	negative
你总感觉的倍变焦是骗人的手感操控性能画质已然全面落后	negative
这个很多人都在说	neutral
防抖的防抖效果好略于防抖	neutral
就是快门声音不怎么样当然这也许是白平衡的问题	positive
周围对焦点日光下对焦无压力	positive
但是阳光下的远景分辨率说句不好听的就像手机拍的一样而且紫边也不小除了价格比较高一些	positive
也有官方的改装服务	neutral
而是采用液晶显示	neutral
的非常差对焦真的没什么优势	positive
朋友给我了一个十分具有说服力的回答	neutral
档的超级功能木有了说明他的电子设计和技术较低端	positive
致命的阳光下看不清屏幕手感操控性能画质已然全面落后	negative
没有画质没有什么出彩的地方	positive
不知为何	neutral
体积和重量都达到了不错的平衡	positive
的对焦和储存速度可以看一下这个视频:///	neutral
长焦端光圈显得小了些拍出人物的皮肤较硬	negative
人家是手机啊	neutral
如果能忍受它缓慢的存储速度的话现在多出来的锁定键做的太	positive
微缩版	neutral
明显听到超深波对焦的声音更大	neutral
镜头上还有一个环	neutral
前几天入得	neutral
画质偏软手感操控性能画质已然全面落后	positive
体积	positive
对孩子脸摸下屏幕	neutral
买的	neutral
拿着来问我自动挡在哪里	neutral
但我没有在包装里面找到高清视频线比偏红偏假的色彩	positive
个人觉得还真是非常好用的	neutral
左上角的拨盘看上去仍然很幼稚因为经常看到有人说的声音一塌糊涂	positive
色彩浓郁透亮且锐度较高	positive
暗部对焦拉风箱我最不满意的是那个删除键	positive
动态对焦连续自动对焦提升明显	positive
给人一种抵挡机的感觉就是这样	neutral
当遇到合适的对象却遗憾的摸摸口袋没有拿出手的拍照设备	neutral
的噪点差不多	neutral
明显敌不过就是不太方便	positive
四没有防抖	negative
锐度偏低但我却很喜欢真实的色彩	negative
可能是用了的系统	neutral
因为《反转模式是增加色彩饱和度	neutral
存储速度慢	negative
没有就是色彩比较淡	negative
没有机内除尘是个问题主要是高清视频录制清晰度差	positive
就是色彩比较淡目前还没有配的既小巧又足够强大的闪光灯	negative
期间一直在用单位的机器到去年的	neutral
另一个是无穷远	neutral
对应近视眼和远视眼用户	neutral
在肩屏的信息显示量上也不够丰富色彩太假	negative
和防抖功能．	neutral
细节较多想问问为什么的照片这么小啊	negative
打开一张照片要秒	neutral
对焦的平衡点	neutral
比差一大截	neutral
拿在手里很有一种厚实感	neutral
手感操控性能画质已然全面落后电子取景器有时滞	positive
一切的性能都是从价位上直接反映出来的	neutral
记得年刚大一	neutral
数据线都不配	negative
但那对焦速度我是受够了	negative
只有从机顶看觉得造型怪异些镜头方面也有不足的地方	positive
没有确实有点影响出片率取景器切换时候会有遮挡	negative
你用左手的那个手指去操作都会觉得别扭	neutral
看着不容易懂	neutral
感觉在变焦的时候有些迟滞照远景效果比许多机子差	positive
手感操控性能画质已然全面落后我发现的色彩非常干	negative
室外拍孩子	neutral
的噪点属于比较大色斑	negative
像那样强调操控的机器	neutral
比国内便宜	neutral
松下的的触摸屏灵敏快速	positive
点的对焦着实很猛	positive
画质	neutral
/的快门大家都非常郁闷外接闪光灯真丑	negative
手感操控性能画质已然全面落后塑料前脸仍然没有升级成合金材料	negative
反转片效果我个人很喜欢	positive
说明他的电子设计和技术较低端拍出人物的皮肤较硬	negative
机内测光容易出错导致过曝	negative
感觉开关拧到距离过长机内软件可能有问题	negative
目前还没有配的既小巧又足够强大的闪光灯存储速度慢	negative
基本是毫无意义地增加了法兰距	neutral
而且使用速度狂慢我用的是苹果一体机	negative
不过手感一般电池不够用	negative
大部分都不清楚我用的快速对焦模式	neutral
的遮光罩为什么总是做的很松不满的是反映速度	negative
我比较注重复杂光线下人物肤色的色彩还原	neutral
实际使用	neutral
出掉已经是月了成都天气一直不太好这阳光机也暂时没用	neutral
下面还是把我买的心里独白写下吧	neutral
这是前一段时间很多帖子口水的地方	neutral
照上述条件开始选机	neutral
就下手	neutral
快门声在体验时最想让我吐槽的就是它的快门声了的噪点属于比较大色斑	positive
但是又一次失望了	neutral
色彩不偏差可能握持上不是太舒服	positive
外观质朴小巧	positive
至少不合适我	neutral
整体感觉就是一入门机的样子电池太渣	positive
而远角端只有拍的好像蒙了一层雾	negative
眼睛不用离开取景器能完成所有基本设置	neutral
随后依个人习惯把图像质量设置为	neutral
缺点	neutral
所以让人感觉塑料感稍重锐度偏低	positive
但是便携性较差就是成像似乎不像是微单的水平	negative
还有相机内的创意滤镜	positive
体积小只是开电池舱盖和卡舱盖的时候能明显感觉到塑料的做工	positive
是的首部机器	neutral
宽容力	neutral
不再玩任何其它品牌机子了	neutral
在无忌潜水很久	neutral
实际拍摄根本没意义	neutral
又借了朋友用了三天	neutral
这只镜头配合起来就有点问题手感操控性能画质已然全面落后	positive
紫边	neutral
而且使用速度狂慢我用的是苹果一体机现在的屏幕裸露在外	negative
貌似只有一个自定义键	neutral
没有这个头的对焦性能并不好	positive
最喜没要的发票居然也给开了机打的	neutral
机器很漂亮	neutral
玩了半年就出掉了主要是边缘成像太差色散严重还有就是确实存在严重的屏偏绿的问题	negative
拨轮和按钮的手感都好过小五	positive
变焦感觉有点慢哦最大的问题是为小体积而小体积	positive
全副镜头在上广角损失严重这头的对焦环	positive
而腾龙出片我个人感觉比较像一个数码记录图像对焦叽叽的叫声让你觉得随时要坏	positive
总有优缺点	neutral
结果对焦和色彩让人失望对焦叽叽的叫声让你觉得随时要坏	positive
色彩太假价格也最高	negative
镜头覆盖广	positive
手持拍摄的成功率很高	neutral
的各种连拍各种视频无压力	neutral
色彩太假键位设置不如全副方便	negative
奥巴的/镜头也是个大块头液晶屏无法关闭盲拍	positive
的电子技术确实不高不深但便携机在图像质量上总是稍欠缺一点还有不能换镜头局限了拍摄题材	negative
高感不好白平衡	positive
我对图像质量的要求颇高	neutral
塑料前脸仍然没有升级成合金材料电子取景器有时滞	positive
片子都不实	neutral
而远角端只有明显敌不过	negative
对焦速度慢这个完全不能和单反比啊感受在对焦的时候有些犹豫	negative
价钱不算低档有问题	negative
带	neutral
对焦烂也就算了就是格式照片有点偏大本人用寸笔记本	negative
色彩不正及过渡不好	negative
除了没有触摸屏以外但是屏幕实在不堪入目	negative
外观变丑了配长焦机身偏小	positive
就一姐夫机的大小图像很硬	positive
洞妖有两种防抖模式	neutral
第一	neutral
它的功能上的确有些不足的遮光罩为什么总是做的很松	negative
机械快门线的确蛋疼就是一台没有电话功能	negative
简单后期照片导出时还是很慢除了没有触摸屏以外	positive
的感光度在的时候也只能说勉强凑合看快门延时稍长	positive
也相应退出了市场	neutral
当然整机都是金属	neutral
对焦速度一般夜景手持真的很吃力	positive
但是外挂电源毕竟影会影响的便携性同样用测试对焦	positive
值吗	neutral
但是长焦是外变焦外观变丑了	negative
因此背景的虚化不足机内测光容易出错导致过曝	positive
测光等完全跟着追踪	neutral
洞妖不算很轻	neutral
尤其配合黑色版本更符合准专业用户通常的喜好	neutral
直出太差了	negative
色彩的话的工业设计真是倒退了三十年	negative
还需要时间来适应	neutral
有利于创作出更富视觉冲击效果的摄影作品	neutral
我在上也发现了这个功能	neutral
基本没用如果能忍受它缓慢的存储速度的话	negative
在菜单里关闭启动画面后	neutral
但是长焦是外变焦	negative
手感操控性能画质已然全面落后玩了半年就出掉了主要是边缘成像太差色散严重	negative
纸质说明书	neutral
我发现的色彩非常干对焦的速度上并不是很突出	positive
开机慢大概秒以上但驱动有点慢	negative
开机慢大概秒以上细节较多	positive
目前对的色彩还在摸索适应中	neutral
周末向杭州格力达俱乐部借了无敌小三使用	neutral
没有一级一级往上试	neutral
体积太大	negative
合眼缘	neutral
说明他的电子设计和技术较低端	negative
加上的一个延长罩更加长	neutral
想问问为什么的照片这么小啊像素密度太密了	negative
发现在这家伙优点很多的	neutral
但每过一段时间	neutral
反差较小时镜头还会拉风箱这个头的对焦性能并不好	negative
实拍几次下来	neutral
但是长焦是外变焦让那些用的女士双臂平伸端着手感很差的克重物显得那么滑稽可笑	negative
电子取景器有时滞还有就是确实存在严重的屏偏绿的问题	negative
电池续航能力一般	negative
真是台强制我不要乱按快门的好机器啊就一姐夫机的大小	positive
还走以后	neutral
你肯定会看到没有的恒定光圈这回事	neutral
但是阳光下的远景分辨率说句不好听的就像手机拍的一样而且紫边也不小	negative
目前价位还是高于的就是色彩比较淡	negative
画面也惨不忍睹外接闪光灯真丑	positive
充电感觉不是很方便但那对焦速度我是受够了	negative
由于试用过程中很匆忙	neutral
关于	neutral
感觉高感效果和宽容度不亚于原来的	positive
功能等功能对于老鸟可能无视	positive
很容易虚化全幅和截幅的区别吧	positive
比如拍的红玫瑰	neutral
但是	neutral
进光量大	neutral
长焦端没有防震比偏红偏假的色彩	negative
比如白平衡没有显示配置一般	positive
细节较多电子取景器有时滞	positive
的感光度在的时候也只能说勉强凑合看所以让人感觉塑料感稍重	positive
仔细点说是和配合的体会	neutral
总觉得相机不给力	neutral
无论是拍鸟还是拍新闻都够用	neutral
犹豫中	neutral
手头的器材是	neutral
但是稍有不同	neutral
其实我觉得那个翻转屏挺好	positive
的对比对焦显然没有的相位对焦快不如做工好	positive
静音快门	neutral
可以选择全部对焦点显示或者只显示选择的对焦点	neutral
可能是口径太大的原因	neutral
成像没有系统测试过	neutral
随便拍的	neutral
是为了便于用家单手持机拍摄的	neutral
晚上拍照比较吃力因为之前的的画质堪称垃圾	negative
电池坚持时间久	positive
觉得不象原电．．．	neutral
虽然在强度上有些降低同样用测试对焦	negative
按键布局很紧凑	positive
机背液晶屏竟然是塑料的	negative
没有必要一步到位	neutral
个人觉得这个东东	neutral
表面上看拥有完全支持单反镜头的优势	positive
必须要的版本才能打开	neutral
家里十多部相机	neutral
同样快门速度有时在长焦段会有拉风箱现象	positive
放弃	neutral
和的高感成像质量相比较而言就有些惨了充电感觉不是很方便	positive
防尘不好	negative
也可以接受	neutral
很大机子的镜头盖的设计会在装上镜后	neutral
稍逊于单反的机械性能	negative
照片暂时没什么能拿得出手的就不上传了	neutral
就拿个的噱头来唬弄用户	neutral
和的高感成像质量相比较而言就有些惨了小黑虽然部分焦段锐度跟不上	positive
对自己好点吧	neutral
没有机内除尘是个问题不喜欢闪光灯的设计	positive
对焦的速度上并不是很突出真的就是系统慢了点	negative
这也是我出掉的其中一个原因	neutral
看着取景器里的对焦点从模糊清晰模糊清晰的过程的确有砸机冲动你总感觉的倍变焦是骗人的	positive
使用一块万像素英寸的液晶屏显示效果不错	positive
目测对焦速度慢于	negative
对焦速度慢四没有防抖	negative
作为参考	neutral
弱光下大光圈加上防抖	neutral
在此机上对焦迅速	positive
总的来说用来拍人像肤色怪怪的无摄像功能	positive
图象完全看不清楚边缘对焦还是比较容易拉风箱	positive
你说请把它配上一个Ⅱ镜头以美金的价格卖给我	neutral
不过感觉快门很涩其次是那个主拨盘	positive
说法相差实在太大	neutral
日本目前网购最低价在万日元约人民币	neutral
因为宝宝长大了	neutral
天体天象	neutral
开机速度跟普通单反差不多	positive
机械快门线的确蛋疼对焦点不行啊	positive
扔进去个也不算过分吧	neutral
很多人觉得造型很怪异机子太小太轻	positive
电池太渣光学取景器聊胜于无	negative
让那些用的女士双臂平伸端着手感很差的克重物显得那么滑稽可笑	negative
镜头部分颇有金属感	neutral
主要是因为色散控制不好的原因缺点是体积略大	negative
但色彩略差于就是色彩比较淡	positive
这机器的重量对我来说正好	positive
防尘不好色彩感觉没有原来的容易调整	negative
但是便携性较差有时候界面操作都会有些许延时现象	positive
机身按钮与功能选单	positive
对焦速度偏慢	negative
发挥了全副应有的水平	neutral
我觉得的机身手感很不理想	negative
然后官网说长焦端最大光圈可以	neutral
以前很多人都说的机身差附带的解软件解出来的效果非常差	negative
缺点如下	neutral
习惯就好了	neutral
菜单里东西蛮多	neutral
一直嫌那两台单反有点笨重	neutral
色彩不够鲜艳	negative
各种详细的性能测评在媒体上已经发表了许多	neutral
的我一会不敢超过在暗处对焦边缘对焦点无力	negative
电池使用寿命短不过该机器已经设计了外接电源的线孔	negative
档案算蛮小的	negative
但驱动有点慢存取慢	positive
拍出来白蒙蒙的的工业设计到底怎么了	negative
不为了糖水	neutral
电子取景器对于	neutral
但是阳光下的远景分辨率说句不好听的就像手机拍的一样而且紫边也不小就只是怪的色彩	negative
底部材料没有改进和的比似乎就少了点相位对焦点	positive
手感更好	positive
尽管的标配没有手柄	neutral
闪光灯就算了直接出片机内处理锐度过头了点	positive
高感就不要太奢求了	negative
情有经验的前辈给点快速设置的建议	neutral
由于我常用长焦拍摄	neutral
毕竟加了转接环还是可以用我的头	neutral
电池存储卡都和完全通用	neutral
才能搞明白里面的东西是怎么回事	neutral
借着新购的契机	neutral
对焦精度太差了	negative
套头用的是原厂	neutral
画质提升多少这里就不细说了	neutral
不如做工好对焦慢	negative
我是个容易满足的人	neutral
在试用后也只能俯首称臣	neutral
所以就看您自己的情况而定了	neutral
由于该机采用了全工程塑料	neutral
我个人认为所有的副的相机的画质都够用	positive
影响如此之深	neutral
感觉机身的自动白平衡有点问题导致无法进行连续拍摄	negative
没一个便宜的	neutral
机壳的主体应该是金属壳	neutral
拍摄时	neutral
就是时的图像质量也可以接受	neutral
我等	neutral
开机慢大概秒以上体积太大	negative
问题是体积也没见小啊但我没有在包装里面找到高清视频线	negative
欢迎补充	neutral
调整到完全是可以用的	neutral
比偏红偏假的色彩价格也最高	positive
软件不太好使手感操控性能画质已然全面落后	negative
这景深伤不起	negative
对焦行程做得那么长不过与相比的机身确实短了一些从左到右方向	negative
不用挣扎	neutral
感觉开关拧到距离过长	negative
这个非常有意思	neutral
不是让你去装的	neutral
结果对焦和色彩让人失望那感觉和效果是脚底抹油也赶不上	negative
所有图都是最大光圈拍的	neutral
很好的防止了因误拨模式转盘导致的拍摄失误	neutral
不过对大光比的控制方面明显不如全副没什么用处	positive
这点仅供大家参考哦	neutral
果断出手	neutral
没有内闪锐度偏低	negative
这电池的型号应该也是一样的	neutral
对焦行程做得那么长	negative
是专业性更强的机子	positive
使用频率来说	neutral
画面颗粒感较强但我没有在包装里面找到高清视频线	positive
但是后来觉得操控上和手感上会威武很多	positive
但是我错了	neutral
感觉开关拧到距离过长手动对焦更慢一些	positive
想到哪写到哪	neutral
同时拿出说明书阅读	neutral
前者可以无视对焦直接按下快门	neutral
对焦慢就是色彩比较淡	negative
也没专业机身塑料感强轻	negative
且目前售价也略高为什么照片这么小	negative
虽然该价格高达多	neutral
不是太暗德地方	neutral
然后就是用手动功能要大	neutral
这景深伤不起机子太小太轻	negative
那还有作为选择	neutral
首先是那个和啤酒瓶子盖一样的模式转盘发现对焦速度有所降低	positive
不说了．	neutral
发现对焦速度有所降低重量重不少	positive
而它极轻的快门声音和微小机震几乎是我所使用过的数码单反中控制的最好的	positive
有什么第三方的大容量电池吗	neutral
害我去买了个吸铁石目镜	neutral
优势明显	neutral
复杂光源下肤色表现非常好	positive
未税	neutral
可能小白会更好	neutral
最后	neutral
旋转环非常方便的在等焦段变换	positive
所以设计理念上不高明其实松下除了画质外	positive
如果录视频用的多又不想关闭声音镜头是一定要入的了就为了的对焦安静	neutral
能拍多少张	neutral
很舒服	neutral
白平衡二是体型偏大了	positive
今天下午去买了一个	neutral
要是能用那片无低通就无敌了	neutral
的对比对焦显然没有的相位对焦快	negative
上市的时候	neutral
手动对焦有但是长焦是外变焦	negative
机身缝隙稍大档的超级功能木有了	positive
它的功能上的确有些不足	negative
比方便	neutral
档有问题个人觉得做工不如	negative
红圈感觉就做的还可以	neutral
只是属于最严重的一类手动对焦更慢一些	positive
两种菜单方式各有各的好处	neutral
光变	neutral
提到	neutral
按第一次出现直方图	neutral
夏天似乎还掉黑色	neutral
拍半身人像特写都很好	positive
用它拍了不少汉口旧租界里的优秀建筑和街道	neutral
对焦的速度上并不是很突出底感差	negative
精度有提升	positive
但是会显得厚了一些．．．	neutral
二是体型偏大了	negative
玩得很开心	neutral
看来确不属天朝的砖家大湿流个	neutral
但是熟悉后	neutral
机背液晶屏竟然是塑料的配置一般	negative
锐度偏低数据线都不配	negative
握在手里比手感要好	positive
而且还有正规的发票	neutral
色彩不正及过渡不好的工业设计真是倒退了三十年	negative
也胜出	neutral
缺点	neutral
你需要点一下快门才能消失	neutral
就是一台没有电话功能长焦端没有防震	negative
说说相对于的感受	neutral
既然和画质差不多	neutral
像内置的	neutral
夜景画质很一般就是成像似乎不像是微单的水平	positive
高感强大	positive
头和金圈都各有特点	neutral
也没专业正面太滑	positive
的最高画质也才一张参数上是这么写着的	neutral
对焦有进步	positive
咋一看很好	neutral
中央五个对焦点很暴力对于有人说它是塑料机身	negative
能撑的起我倍光变/秒的防抖能力	neutral
主要是没用过这种产品	neutral
镜头是不错	positive
觉得太麻烦	neutral
非常重要的特性	neutral
这头的对焦环感受在对焦的时候有些犹豫	positive
没有所说工程塑料的玩具感那么夸张	neutral
也是如此的设计电子取景器有时滞	negative
防尘不好其余的对焦点	negative
片子发暗种种现象手柄突出部分和镜头对焦环之间的空间挤了点	positive
拍的好像蒙了一层雾松下出来的图片的比对度的确有点不够	negative
只是开电池舱盖和卡舱盖的时候能明显感觉到塑料的做工感觉机身的自动白平衡有点问题	negative
小黑虽然部分焦段锐度跟不上如果能有对焦微调	negative
边缘对焦还是比较容易拉风箱充电感觉不是很方便	positive
光圈优先模式	neutral
对焦速度问题	positive
虽说不太认同感动家的机身设计	negative
二成像质量	neutral
系列的画质一般档的超级功能木有了	positive
对焦点选择不是很方便而且使用速度狂慢我用的是苹果一体机	positive
速度就慢下来	neutral
为什么	neutral
按键按起来啪啪响图像很硬	positive
对也是刮目相看了	neutral
但色彩略差于取景器切换时候会有遮挡	negative
真是台强制我不要乱按快门的好机器啊白平衡只能菜单调	negative
旧机手握时稍显单薄	neutral
闪光灯没有闪光灯外盖分成了三部分	negative
已经推出快个月	neutral
用光需要比以前更加注意	neutral
白天晚上预先调整下白平衡	neutral
没有	negative
同时排满过一次	neutral
值得一说的就是色温的设定	positive
小了一些	neutral
画质偏软我发现的色彩非常干	negative
买前和比较了一下	neutral
我几乎把机器玩了个够	neutral
/的快门大家都非常郁闷没有多次曝光功能	negative
主要是最小光圈只到和的高感成像质量相比较而言就有些惨了	negative
喜欢的外观	positive
/的快门大家都非常郁闷微距自动对焦较慢	negative
对焦的确非常非常慢高感有说不如的	positive
的确的背景虚化不太好做对焦叽叽的叫声让你觉得随时要坏	positive
高感有说不如的对焦行程做得那么长	negative
在菜单里关掉快门音量以后	neutral
密封不好等色彩不偏差	positive
我手持拍摄的出片率较低不过与相比的机身确实短了一些从左到右方向	negative
但感动的镜头的确是一流的外观	positive
有的几率在电脑上打开相机后	neutral
刚到手一试真的让我有种想吐的感觉	neutral
注意	neutral
四没有防抖出来的片子更糟	negative
毕竟比便宜了元	neutral
握感很好	neutral
肤色偏金黄色这景深伤不起	negative
操控缩水光线暗的时候对焦拉风箱	negative
不过老机器也够	neutral
手动对焦时	neutral
我觉得还是很用有的	neutral
对于不用闪光灯的我	neutral
都需要手动去调节合适当时场景的白平衡	neutral
万素虽然过时	neutral
但我没有在包装里面找到高清视频线出来的片子更糟	positive
头几年一直在用和	neutral
手动支持	neutral
就说下设计上的不足密封不好等	positive
的遮光罩为什么总是做的很松就是紫边太严重	negative
比如白平衡没有显示外观既没有时尚	positive
说法相差奇大	neutral
几个机器都能满足工作需要	neutral
它的功能上的确有些不足光学取景器聊胜于无	negative
这个头的对焦性能并不好另外高感也差很多	negative
以后用不用单说	neutral
比想象中大很多	neutral
的工业设计到底怎么了此头焦外绿边十分严重	positive
手感操控性能画质已然全面落后小黑虽然部分焦段锐度跟不上	negative
小五就成打酱油的但在自动对焦操控感受上还存在一定差距	positive
这对焦屏绝对给人耳目一新的感觉	positive
刚拿上手还没试过	neutral
景深预览键没有对焦慢	negative
接图的效果也不如手柄也太小	negative
对于	neutral
玩了半年就出掉了主要是边缘成像太差色散严重高感不好	negative
而几乎瞬间就牢牢抓住了主体	neutral
只是属于最严重的一类说明他的电子设计和技术较低端	negative
这个头的对焦性能并不好它的功能上的确有些不足	negative
广角端边缘锐度不行压缩比有些点	positive
但是强劲的机能会弥补画质的不足导致无法进行连续拍摄	positive
但对我们使用者有二个概念应该是清楚的	neutral
奥林巴斯买来已有二周了	neutral
操作系统反映速度很慢体积太大	positive
个人觉得高感最多强一档	neutral
操作够复杂的	negative
默认是	positive
如果不是要求零噪点	neutral
忍受不了最近低价的诱惑	neutral
像素密度太密了	negative
和的高感成像质量相比较而言就有些惨了	negative
它相机里电池自行放电由来已久边缘对焦还是比较容易拉风箱	negative
三对焦点那个多啊	positive
握感和差不多	neutral
也有紫边的我一会不敢超过	positive
由于镜头不再伸缩镜头内排线故障可以排除	positive
发现成像和锐度完全不行	neutral
的对焦的确的背景虚化不太好做	negative
半按快门才打开的	neutral
看到香港出来	neutral
或者是冲印寸左右的照片	neutral
对于这两款机子的选择	neutral
朋友还是很爱惜的	neutral
奥巴的/镜头也是个大块头	negative
结果对焦和色彩让人失望机身缝隙稍大	positive
但我把这个功能看作是相机的一种附加或赠送的功能	neutral
对焦叽叽的叫声让你觉得随时要坏对焦真的没什么优势	negative
好在	neutral
全点十字型自动对焦感应器	neutral
提升都不大	neutral
那个蜗牛就别考虑了	neutral
第一个感觉就是比卡片机好太多	neutral
不过与相比的机身确实短了一些从左到右方向稍逊于单反的机械性能	negative
体积太大机身塑料感十足	positive
宾得擅长制作高品质的小镜头	positive
套头成像颜色偏冷	negative
机身手感一般	negative
算的太清了	neutral
俯视取景	positive
有空時会补上或是鏡的测试	neutral
和都有超高速连拍	neutral
这个头的对焦性能并不好对焦行程做得那么长	negative
的机身依旧采用工程塑料没有机内除尘是个问题	negative
的蔡司头	neutral
很轻便	neutral
想问问为什么的照片这么小啊和开头的机器甚至开头的机器都不相符的塑料卡口	positive
对焦精度太差了首先是那个和啤酒瓶子盖一样的模式转盘	positive
可以顺势把电池做大	neutral
也是如此的设计目前价位还是高于的	negative
的无论是对焦速度暗部对焦能力还是合焦成功率	positive
外形对于全幅机来说算是比较小巧	positive
不过	neutral
怎么压缩后传到无忌上这么不清楚了	neutral
说明他的电子设计和技术较低端操作系统反映速度很慢	negative
很不方便	neutral
感觉一英寸大底确实不错	positive
终于选择入手啦	neutral
对焦的速度上并不是很突出致命的阳光下看不清屏幕	negative
洞妖薯片出的画质	neutral
很	neutral
改天买个转接环试试看	neutral
没什么特点	neutral
尤其是那个白墙对焦的传说	neutral
缺点也说完了	neutral
手感操控性能画质已然全面落后真的就是系统慢了点	positive
中心相当于边沿	neutral
个对焦框太大了炒冷饭	positive
照片又会自动的翻转一次．	neutral
的早期固件竟然不支持最大光圈为的镜头自动对焦	neutral
脖子都要肿了	neutral
不过如果用中性模式	positive
手柄也太小键位设置不如全副方便	negative
存储的一半时间其实是在机内处理	neutral
所以能花不到两万的价格买到一款和大马三相同象素的机身	neutral
主要是最小光圈只到底感差	negative
机身蒙皮磨蚀严重就是的色散比重引起的	positive
对焦精度太差了价格相对昂贵	negative
我觉得的机身手感很不理想晚上拍照比较吃力	positive
光学取景器聊胜于无的非常差	positive
还是挺厚实的	neutral
而且都刀了	neutral
锐度偏低操作的时候小里小气的	positive
掌握视觉非常方便	neutral
操作的时候小里小气的锐度偏低	positive
内闪	neutral
我的就是最小的暗部噪点也清晰可见自动白平衡在某些特定场合容易出錯	positive
肩屏显示的信息很多左侧的接口布局有了改变	positive
到底如何	neutral
不管从速度还是精确度上	neutral
开箱后第一感觉就是	neutral
的对焦系列的画质一般	negative
防尘不好几个小按钮的感觉也是如此	negative
一手拿手机取景拍照好比偷拍	neutral
但限于镜头焦段的限制	neutral
洞妖的明显要慢于的但在基本的锐利度表现	negative
就连包装箱也是一层层翻开	neutral
片子发暗种种现象没有	positive
个人觉得做工不如	negative
价格对我来说也贵了操作系统反映速度很慢	negative
新一代暗处色彩丢失可能是因为噪音太大导致严重降噪抹除了颜色只是控制和手感恐怕没有这么舒服	negative
不知道设计师到底怎么想的	neutral
肤色偏金黄色其实松下除了画质外	negative
对于有人说它是塑料机身手柄突出部分和镜头对焦环之间的空间挤了点	negative
主要是因为色散控制不好的原因就感觉出来的片子更糟	positive
我觉得的机身手感很不理想同样快门速度	negative
但是不幸在我存的钱够的时候刚好上市了	neutral
如果是装到衬衫的兜里呢	neutral
但在基本的锐利度表现	negative
感光度白平衡测光对焦模式画质连拍速度等常用设置都可以在步操作以内进行调整	neutral
无摄像功能真是台强制我不要乱按快门的好机器啊	negative
也许以后必要的时候还真可以拍上用场呢	neutral
当然这也许是白平衡的问题用转接要好很多但又没有了自动对焦	negative
刚上手觉得操作特别困难二是体型偏大了	positive
度旋转液晶太好用了	positive
很多人觉得造型很怪异	negative
但经过长时间观察	neutral
还有一个方案就是买的机身配系列镜头	neutral
防抖功能还行	positive
对焦	neutral
另外高感也差很多只有从机顶看觉得造型怪异些	positive
区双层测光	neutral
四没有防抖只不过应该会耗费不少电力吧	negative
的确的背景虚化不太好做的对比对焦显然没有的相位对焦快	positive
终于现身	neutral
说下感受	neutral
缓解了单电系统对焦点选择不便的软肋相对单反	neutral
那感觉和效果是脚底抹油也赶不上	negative
密封不好等其实松下除了画质外	negative
测试镜头/	neutral
感觉机身的自动白平衡有点问题目前价位还是高于的	negative
对焦慢机身蒙皮磨蚀严重	negative
只有一个外置接口但体积不小	positive
因此背景的虚化不足一是太小完全不像是消费专业级数码相机的水平	negative
机身背后按键设置与大拇指操作配合得不错	positive
这些措施都是为了尽量减少内部反光造成的杂光	neutral
和会议啊等等的场合还是比较有用的	neutral
下面说说感受	neutral
出来的片子更糟只是控制和手感恐怕没有这么舒服	positive
还是原装的好啊	neutral
可是定焦也太小气了洞妖的明显要慢于的	negative
也不能代表大众观点	neutral
的对焦不过与相比的机身确实短了一些从左到右方向	positive
只不过应该会耗费不少电力吧这头的对焦环	positive
电池不够用很多人觉得造型很怪异	positive
现在的按键用起来不爽充电感觉不是很方便	negative
广角端边缘锐度不行左侧的接口布局有了改变	positive
刚上手觉得操作特别困难外观变丑了	positive
拍出来的照片色调有些奇怪图像很硬	positive
拍出来白蒙蒙的只是控制和手感恐怕没有这么舒服	negative
曝光	positive
白平衡准确	positive
之前用了两年宾得	neutral
快门打到尽然有重影闪光灯就算了	negative
拨轮和按钮的手感都好过小五	positive
可是	neutral
有触摸屏操控的话	neutral
大概可以拍四五百张吧	neutral
目测对焦速度慢于防尘不好	positive
这么冷的天一摸容易出手汗啊	neutral
做工一般底部材料没有改进	negative
菜单改变感受	neutral
怎么用相信大家能想象的出	neutral
洞妖的宽容度应该跟小五是一个级别的	neutral
长曝拍风景	neutral
确实要小一圈	neutral
其实松下除了画质外但我却很喜欢真实的色彩	positive
没事就提着相机去街上	neutral
的噪点属于比较大色斑这景深伤不起	positive
对焦行程做得那么长对焦精度太差了	negative
去掉了金刚屏有点不习惯	neutral
我手持拍摄的出片率较低色彩太假	negative
快门声在体验时最想让我吐槽的就是它的快门声了电池太渣	negative
原来用过	neutral
索性试一试机器	neutral
配置一般基本没用	positive
只是希望能对打算买的朋友有所帮助	neutral
古怪的玩意	neutral
我倒是反而愣了一下	neutral
就觉得丑	neutral
也许它不是成像最优异的机身	neutral
的小相机终于发布了	neutral
快门触感变深这个头的对焦性能并不好	negative
对焦速度是目前单电系统软肋手柄也太小	positive
小地方更伤不起	neutral
雷克莎有款的卡	neutral
液晶屏像素太低机身手感一般	positive
数码镜头优化初步感受	neutral
正火热闹之时	neutral
的噪点属于比较大色斑也有紫边	negative
野外用有抓不牢的感觉;	neutral
表现在取景器和想比高速卡帮助不大	negative
并且使用卡储存的数码设备也有很多	neutral
但大大改善了一个系统的使用体验	neutral
的单反/单电相机	neutral
目测对焦速度慢于我手持拍摄的出片率较低	positive
反而对的黄金像素留口水	neutral
个人感觉收获良多	neutral
官方说法是要用滤镜转接器转接转接	neutral
质量还不如以前的快门触感变深	negative
镜头组那叫一个咣当	neutral
希望对大家的选择有帮助	neutral
都是使摄影爱好者选择它的理由	neutral
既然数码时代都流行防抖了	neutral
这样选择镜头的面就窄了一些	neutral
色彩不偏差	negative
估计会进个/	neutral
速度快了	neutral
取消混合取景	neutral
这两者的定位从参数上就能看得非常清楚	neutral
芯片面积仅仅大了倍	neutral
如果是用	neutral
但是比头好的是	neutral
韩国的中国的配件相继会面世	neutral
年下半年	neutral
总结	neutral
早就关注这货了	neutral
有时候界面操作都会有些许延时现象也不好逃出紫边	positive
的镜头平时拍拍小孩	neutral
有一定几率反复拉风箱	neutral
档案算蛮小的而腾龙出片我个人感觉比较像一个数码记录图像	negative
用过/系统的人绝对会受不了的触摸屏完全没有发挥半透镜优势的对焦张/秒的连拍速度	negative
感觉在变焦的时候有些迟滞画质偏软	positive
不比入的时候	neutral
广角端边缘锐度不行为什么照片这么小	positive
小五就成打酱油的边缘对焦还是比较容易拉风箱	positive
没什么用处首先是那个和啤酒瓶子盖一样的模式转盘	positive
后来我调节快门至	neutral
的工业设计到底怎么了不如做工好	negative
致命的阳光下看不清屏幕暗部对焦拉风箱	negative
但很难达到电脑合成的那种虚幻的感觉只能算虚假吧差距不小	neutral
在暗处对焦边缘对焦点无力机械快门线的确蛋疼	positive
买到也是一次摸到实物	neutral
就选了	neutral
谁用谁知道的机子	neutral
毕竟的和定焦头太迷人了	positive
但驱动有点慢最烦人的是不能全时手动	positive
其实平时照相很少用到这种极端快门	neutral
切机身严防磕碰的感光度在的时候也只能说勉强凑合看	negative
看了配饼干头的评测	neutral
这个就是现实	neutral
	neutral
是一部塑料玩具	neutral
和品牌关系不大	neutral
要多加练习	neutral
但是便携性较差不过对大光比的控制方面明显不如全副	positive
上了小痰盂	neutral
只有从机顶看觉得造型怪异些高速卡帮助不大	positive
但是阳光下的远景分辨率说句不好听的就像手机拍的一样而且紫边也不小如果能忍受它缓慢的存储速度的话	negative
接触单反也有三四年了	neutral
市场上同级别的可换镜头相机都差不大多	neutral
机身塑料感十足的噪点属于比较大色斑	negative
肩屏显示的信息很多快门打到尽然有重影	positive
套机左右	neutral
不过手感一般这景深伤不起	positive
色彩灰暗但我宁可这样也不要糟糕的做工	negative
当然和和比	neutral
系列的画质一般试过边缘对焦	negative
不过手感一般但在大光圈长焦和闪光灯上还有不足	negative
就只是怪的色彩按键按起来啪啪响	negative
爱之深	neutral
没有宾得的鲜锐感	positive
对焦慢但我没有在包装里面找到高清视频线	negative
以此换来的	neutral
比还要短些	neutral
再说说旁边的	neutral
只是控制和手感恐怕没有这么舒服但因为绿屏问题实在让我觉得膈应	positive
但便携机在图像质量上总是稍欠缺一点还有不能换镜头局限了拍摄题材真是台强制我不要乱按快门的好机器啊	negative
室内人像拍摄时	neutral
在动物世界里从来只会因为有而高兴	neutral
这一个星期左右的时间里	neutral
展台给上的是	neutral
特别是电池舱盖只有从机顶看觉得造型怪异些	negative
每次出门都情不自禁拿出	neutral
感受了一下的性能	neutral
年月	neutral
在试机的时候已经觉得的外形用在手上比看图片要帅多了	positive
心里一狠就上了	neutral
我拍了张充了次电	neutral
它的系统也是年之前的款好	neutral
的是	neutral
的电池型号是电池容量是	neutral
其实的设计并没有那么糟糕	neutral
色彩不够艳	neutral
二是体型偏大了虽说不太认同感动家的机身设计	negative
安装时可以选择简体中文	neutral
但在基本的锐利度表现画质没有什么出彩的地方	positive
机身直接支持遥控是我比较喜欢一类低档机身的原因之一	positive
为保证大格式文件的储存速度	neutral
电子取景器的使用可以外接电子取景器	neutral
不适合装	neutral
我常会随身携带的是	neutral
全副镜头在上广角损失严重画质偏软	negative
和的比似乎就少了点相位对焦点色彩不正及过渡不好	negative
搭个台子在宣传	neutral
感觉没有以前用的清脆	neutral
当然	neutral
别买就好了	neutral
光线暗了以后	neutral
快门清脆	positive
的非常差几个小按钮的感觉也是如此	negative
画质很好	positive
价格贵不少二是体型偏大了	positive
显得有些弱智	neutral
高感确实很有用	neutral
操作的时候小里小气的用的时候快门声音很怪	positive
色彩太假	negative
如果要一台全天侯机器	neutral
简单后期照片导出时还是很慢但我宁可这样也不要糟糕的做工	negative
洞妖的软肋	neutral
印象最深的是	neutral
其他象手感操控啊	positive
对焦你需要多点十字对焦吗	neutral
真是贴心啊	neutral
看买家自己的喜好啦	neutral
加上万像素	neutral
我建议中文版的菜单可以优化一下说法	neutral
就是一台没有电话功能	negative
没有多次曝光功能感觉手柄还是略小	negative
有了以后在阶段的机子都可以忽略了	neutral
人脸识别识别率木有手机或者强色彩不够鲜艳	negative
拿在手上就很合适了	neutral
其他片子感觉也还是很不错的局限于电脑显示	positive
对焦速度慢这个完全不能和单反比啊结果对焦和色彩让人失望	negative
导致无法进行连续拍摄电池续航能力一般	negative
虽然我只会用到中间的一个点	neutral
手机就是手机	neutral
的我一会不敢超过目测对焦速度慢于	positive
没有闪光灯也没专业	positive
尺寸应该也比镜头要小错了请纠正	positive
有时候界面操作都会有些许延时现象炒冷饭	positive
走了很多冤枉路	neutral
这么密的小像素对焦点的选择也略蛋疼	positive
现在使用了三周	neutral
而腾龙出片我个人感觉比较像一个数码记录图像的噪点属于比较大色斑	positive
但是对于用了很久的人来说	neutral
顶级机身性能	positive
在此要特别鸣谢老婆大人义务出镜做模特	neutral
格式连拍坑爹操作系统反映速度很慢	positive
可以多花些钱上	neutral
屏幕用这么差的材料就感觉出来的片子更糟	negative
机身手感一般色彩不正及过渡不好	negative
拍摄过程还有一点让我愉悦的	neutral
噪点控制不错	positive
但在自动对焦操控感受上还存在一定差距但便携机在图像质量上总是稍欠缺一点还有不能换镜头局限了拍摄题材	positive
就是成像似乎不像是微单的水平快门声音真心不好听	positive
到手之后的第一印象	neutral
不能不提到这个功能	neutral
最烦人的是不能全时手动总的来说用来拍人像肤色怪怪的	negative
便宜好用的自动镜头少色彩不偏差	negative
靠新固件能解决到什么程度待观察	neutral
目测对焦速度慢于奥巴的机器握感都不好	negative
二扬长避短	neutral
	neutral
第一台能真正替代单反的无反相机	neutral
看看对焦	neutral
自认为对它已经有了一定的了解	neutral
这个头主要是对宾得的小公主心仪已久	neutral
浅浅的谈一下使用感受	neutral
的确相比较而言	neutral
隐藏在档	neutral
明显敌不过我最不满意的是那个删除键	negative
我主要是用来拍下风景和接观鸟镜拍鸟	neutral
液晶屏无法关闭盲拍	negative
取景器切换时候会有遮挡让那些用的女士双臂平伸端着手感很差的克重物显得那么滑稽可笑	positive
就是紫边太严重比偏红偏假的色彩	negative
对焦烂也就算了	negative
抗曝死能力极高	positive
晚上拍照比较吃力用转接要好很多但又没有了自动对焦	negative
目前还没有配的既小巧又足够强大的闪光灯	negative
总体印象	neutral
在暗处对焦边缘对焦点无力	negative
不足之处	neutral
没有闪光灯的电子技术确实不高不深	negative
虽说不太认同感动家的机身设计就感觉出来的片子更糟	positive
也不新手	neutral
目前看感觉照片效果不如上周买的的松下	negative
特别的时候	neutral
人脸识别识别率木有手机或者强亮度还是偏低	positive
不但拥有惊人的对焦速度	positive
噪点也低	positive
表现在取景器和想比就是不太方便	positive
没有多拍;	neutral
开机慢大概秒以上数据线都不配	negative
一机两头	neutral
其实速度是很快的	neutral
变焦阻尼手感还行	positive
对焦点的明暗反差要求比较高	positive
如果不是因为我有四个头	neutral
的感光度在的时候也只能说勉强凑合看的机身依旧采用工程塑料	positive
说明他的电子设计和技术较低端只是控制和手感恐怕没有这么舒服	negative
不喜欢闪光灯的设计没有确实有点影响出片率	positive
目前等效/这个人文焦段的大光圈定焦头的无反数码相机中	neutral
比也好一些	neutral
取景视野	neutral
快门触感变深单点对焦试了几张	positive
有点像机关枪	neutral
是一台给人拍照的机子	neutral
高感带给我的是感动	positive
高感很多人赞过	positive
对它在左上角的取景框一直很在意	neutral
但是重就一个字	neutral
是颜色表现更舒服	positive
同样用测试对焦但在大光圈长焦和闪光灯上还有不足	negative
虽说这款机很多的缺点	neutral
测光用点测或者平均测	neutral
没有内闪缺点是体积略大	negative
致命的阳光下看不清屏幕奥巴的/镜头也是个大块头	negative
结果对焦和色彩让人失望价格也最高	positive
整体手感还是不错的	positive
用转接要好很多但又没有了自动对焦镜头突出很多	negative
的机身依旧采用工程塑料白平衡只能菜单调	positive
今天不是要求跟它厂一样高纯净或者高锐利度	neutral
都是很弱的	neutral
年月日果断下单	neutral
也尝试了一下用高速连拍来抓拍运动的人	neutral
操控缩水做工一般	negative
当然是手动的	neutral
机身蒙皮磨蚀严重	negative
最直观的是两者的对焦点数量	neutral
机器内闪只有当然这也许是白平衡的问题	positive
握感很舒服	positive
左侧的接口布局有了改变对焦慢	positive
它都补上了	neutral
价钱还这么低	neutral
只有从机顶看觉得造型怪异些亮度还是偏低	negative
还有这个选择	neutral
比较简直不是一档次的	neutral
玩一周后感受	neutral
最终选择	neutral
这个焦段用途是最广的	neutral
快门声音真心不好听在肩屏的信息显示量上也不够丰富	positive
先观察了操作面板上的按键	neutral
说明他的电子设计和技术较低端没有闪光灯	positive
降噪为标准时	neutral
没有任何提示和显示而远角端只有	negative
拍的不好大家轻拍	neutral
也算用过两年用过一周	neutral
对焦烂也就算了闪光灯就算了	positive
而一味追求器材	neutral
有时在长焦段会有拉风箱现象快门声在体验时最想让我吐槽的就是它的快门声了	positive
肩屏显示的信息很多但我宁可这样也不要糟糕的做工	positive
拿下了和	neutral
的手感虽然少了的厚重感就是格式照片有点偏大本人用寸笔记本	negative
这只镜头配合起来就有点问题让那些用的女士双臂平伸端着手感很差的克重物显得那么滑稽可笑	negative
当然这也许是白平衡的问题	negative
只是属于最严重的一类	negative
如果很有米绝对入一个	neutral
体验体验	neutral
机身塑料感强轻按键按起来啪啪响	negative
目前价位还是高于的取景器切换时候会有遮挡	negative
带女儿去公园的时候可以派上用场	neutral
同样快门速度有时候界面操作都会有些许延时现象	negative
的操控性要强些	positive
色彩不正及过渡不好充电感觉不是很方便	negative
直接出片机内处理锐度过头了点高速卡帮助不大	negative
光线充足被摄物体反差足够的情况下基本上可以做到拿起来就拍	neutral
和今天一起到家啦	neutral
有传统的味道	neutral
画质和高感	neutral
的大晶彩屏在强光下表现	neutral
七年前单反远没有现在这样普及	neutral
系统的系系和系的摄像功能都相当强大	positive
解除我原来最大顾虑	neutral
用了这些日子	neutral
光圈范围是	neutral
呵呵	neutral
细节较多就说下设计上的不足	negative
但是像素比较低现在觉得我完全不需要高像素这点下面我会解释	negative
现在的屏幕裸露在外镜头方面也有不足的地方	positive
责之切	neutral
老用户需要时间去习惯	neutral
在方面	neutral
价钱不算低我是从来不敢使用以上的感光度去拍人像的	positive
图像回放的时候可以全屏显示	neutral
初看真是小	neutral
虽说不太认同感动家的机身设计广角端边缘锐度不行	positive
配置一般档有问题	negative
机械快门线因为是机械传动	neutral
突起部分起到了很好的握持支撑	positive
键位设置不如全副方便功能不如	positive
有别家单反的用户提出质疑	neutral
你一去按	neutral
这张附图还不是最严重的	neutral
如今的机子更新换代这么快	neutral
主要就是集中在对焦和材质上	neutral
快门声音真心不好听其实松下除了画质外	negative
除非你用格式可以高速连拍大几十张	neutral
如果我发一个帖子说我想要一个镁合金机身	neutral
此头焦外绿边十分严重的对比对焦显然没有的相位对焦快	negative
高感也不错	positive
质量还不如以前的	negative
手柄也太小	negative
和的区别很明显	neutral
锐度偏低电池使用寿命短不过该机器已经设计了外接电源的线孔	negative
便宜好用的自动镜头少但我宁可这样也不要糟糕的做工	positive
它的功能上的确有些不足画质偏软	negative
如果你是在抓拍	neutral
不重复	neutral
今天刚拿到	neutral
拍物品还行	neutral
但我宁可这样也不要糟糕的做工只有一个外置接口	negative
总的来说用来拍人像肤色怪怪的转盘和那个十字大按键有些容易误操作	negative
如果你是拍风光的或是拍生态的	neutral
按键按起来啪啪响光学取景器聊胜于无	negative
好像未证实可以使用跟和相同的手动灯和引闪器了	neutral
特别是电池舱盖白平衡只能菜单调	negative
拍出人物的皮肤较硬切机身严防磕碰	negative
闪光灯没有闪光灯底部材料没有改进	positive
如果能有对焦微调没有任何提示和显示	negative
手感我觉得更好	positive
机身高感表现还算不错	positive
没有机内除尘是个问题目前看感觉照片效果不如上周买的的松下	negative
很好	neutral
在这一年中	neutral
个人的实际感受是	neutral
有种德味哈哈	neutral
无摄像功能四没有防抖	negative
试过边缘对焦目测对焦速度慢于	negative
却经常在镜筒的最前端厘米处无缘无故的突然收缩镜筒	neutral
很大程度上保持了前几代的操作方式	neutral
快门声音真心不好听存储速度慢	positive
给我的感觉和我以前用的和差不多	neutral
手感操控可玩性都具备了	positive
缺点是体积略大没有机内除尘是个问题	positive
稳定性照电子快门线和遥控器差的多体积小	positive
这次主要是在内拍了几张照片	neutral
现在这个样子怎么看怎么像镜头长倒过来似的用的时候快门声音很怪	negative
也就意味着宾得的招牌软件无法编辑这个	neutral
相较于之前的器材	neutral
追焦时准确度:	neutral
和的比似乎就少了点相位对焦点直接出片机内处理锐度过头了点	negative
[:补充如下]	neutral
另外	neutral
远赶不上	neutral
就是成像似乎不像是微单的水平但我却很喜欢真实的色彩	negative
操作系统反映速度很慢对焦行程做得那么长	positive
要是沿用了顶级对焦	neutral
可玩性还是挺高的	positive
的非常差/的快门大家都非常郁闷	negative
不知道楼主摸没摸过真机	neutral
色彩不够鲜艳画质没有什么出彩的地方	positive
上娃的片大家一起交流	neutral
尤其是曝光锁定键价格也最高	positive
但是由于截幅机不能很好的反映镜头的视角	neutral
想了想	neutral
即使最依赖单反系统的	neutral
用的时候快门声音很怪最大的问题是为小体积而小体积	positive
就是紫边太严重	negative
和开头的机器甚至开头的机器都不相符的塑料卡口开机慢大概秒以上	negative
感受在对焦的时候有些犹豫虽说不太认同感动家的机身设计	positive
配备的显示器显示效果比较真实	positive
对焦很快	positive
寸万象素的液晶屏有点落伍了电池不够用	negative
受限机身大小	neutral
方便浏览照片	neutral
重量体积不是负担	positive
玩了半年就出掉了主要是边缘成像太差色散严重功能不如	positive
在光线充足条件下	neutral
画质没有什么出彩的地方存储速度慢	negative
录像按钮价钱不算低	negative
压缩比有些点就是一台没有电话功能	negative
当然也存在一些问题	neutral
一看取景器里就感觉很给力啊	neutral
新机可以随时买到老机不常有啊	neutral
对焦速度一般夜景画质很一般	positive
就这点	neutral
追焦很到位	positive
就是快门声音不怎么样其实松下除了画质外	positive
不日到货	neutral
大家会在入手后释怀的	neutral
说重点	neutral
手感操控性能画质已然全面落后	negative
四白平衡和颜色超准确的	positive
方便后人	neutral
出去拍了两次	neutral
觉得自己不会买	neutral
下图设置为	neutral
但考虑到是卡片机中唯一大底一英寸	neutral
换门伤不起	neutral
小遗憾吧	neutral
镜头都是	neutral
并未见与单反有太大区别前提是不放很大尺寸	neutral
四没有防抖但是强劲的机能会弥补画质的不足	positive
感觉是传承的发扬	neutral
没什么用处质量还不如以前的	negative
我是用了很长时间还是在看图片的时候不自觉地按上几下	neutral
觉得胡说八道的就忽略好了	neutral
对焦点有点集中照远景效果比许多机子差	negative
数码单反相机是入门级单反相机的最新型号	neutral
定之	neutral
自动白平衡在某些特定场合容易出錯转盘和那个十字大按键有些容易误操作	positive
但只要天色一暗下来	neutral
一是太小完全不像是消费专业级数码相机的水平对焦真的没什么优势	negative
自正式公布后一直在关注	neutral
锐度好	positive
还是能明显的看出来的	neutral
我最偏爱的人像镜头是/	neutral
左右原厂皮套和遮光罩	neutral
毕竟是的高级卡片数码相机	neutral
升级	neutral
质量还不如以前的对对焦点的明暗反差要求比较高	negative
第一感觉就是重	neutral
这个功能让所有的卡口镜头都具备全时手动对焦的能力	neutral
键位设置不如全副方便机身蒙皮磨蚀严重	negative
此头焦外绿边十分严重	negative
哈哈	neutral
前部哑光磨砂喷漆	positive
顶部和后部的按键排列和位置基本一致	neutral
目前	neutral
内置的很不错	positive
旧式菜单在熟悉相机菜单结构后可以更快的操作	neutral
而且定价太高了肩屏小了些	positive
微距广角长焦都有了	neutral
而且升级为内闪可以用作无线遥控引闪的原厂闪光灯	neutral
没有就是一台没有电话功能	negative
我尝试过在夜晚路灯照射的环境下对深色物体进行对焦	neutral
按键的设置个人觉得很科学	positive
在还是可以忍受的	neutral
机身蒙皮磨蚀严重色彩灰暗	positive
以前很多人都说的机身差光线暗的时候对焦拉风箱	positive
认为这是环保设计	neutral
也不好逃出紫边机内软件可能有问题	positive
镜头向下镜筒会伸出	neutral
其余的对焦点细节较多	negative
现在这个样子怎么看怎么像镜头长倒过来似的感觉看不出噪点	negative
屏幕太破了对焦慢	positive
的我一会不敢超过目测对焦速度慢于	positive
使用感受	neutral
在和小白之间纠结的死去活来	neutral
由于图像表现出色	positive
接下来谈谈缺点	neutral
夜景画质很一般档案算蛮小的	positive
在这个价位下	neutral
一是太小完全不像是消费专业级数码相机的水平就是色彩比较淡	negative
和的高感成像质量相比较而言就有些惨了左侧的接口布局有了改变	negative
的全钢机身带来的是无与伦比的重量	positive
文档里都不说自己的写入速度只有	neutral
微距自动对焦较慢就是色彩比较淡	positive
这点希望求证使用这个镜头的老鸟	neutral
配略微不平衡	neutral
对焦速度是目前单电系统软肋色彩灰暗	negative
另外不用《反转模式	neutral
为什么照片这么小全副镜头在上广角损失严重	positive
中庸的色彩和较小的反差度的照片风格适合绝大多数人的口味	positive
都比现在的产品漂亮倍	neutral
照片上看着很塑胶感	neutral
稍逊于单反的机械性能简单后期照片导出时还是很慢	negative
基本都是用拍摄的	neutral
片子发暗种种现象快门声在体验时最想让我吐槽的就是它的快门声了	positive
可以这么说	neutral
我和连接后不但可以遥控拍摄还可以即时回看拍摄的照片效果	neutral
辅助对焦的开/关	neutral
但我没有在包装里面找到高清视频线就是成像似乎不像是微单的水平	negative
然后得出结论多好多好	neutral
和	neutral
按键镜头等做工不错	positive
细节较多尤其是曝光锁定键	positive
对焦烂也就算了致命的阳光下看不清屏幕	negative
画质没有什么出彩的地方	negative
看看第一二代	neutral
可以忽略	neutral
但感觉操控性	positive
试用了一下	neutral
快门延时稍长	negative
单反是靠反光板反射到对焦模块上进行对焦判断的	neutral
许多后期效果过于夸张	neutral
/的快门大家都非常郁闷就是对焦前先来回抽一下让人蛋疼	positive
简单后期照片导出时还是很慢手动对焦有	positive
寸万象素的液晶屏有点落伍了六的手动对焦环是假的是对焦环不是变焦环它的手动变焦环很爽	negative
可是角度近乎度虽然不能翻转	neutral
个人感触最深的就是拨轮凸起的设计	neutral
外观变丑了就只是怪的色彩	negative
但是阳光下的远景分辨率说句不好听的就像手机拍的一样而且紫边也不小感觉开关拧到距离过长	positive
像素密度太密了白平衡只能菜单调	negative
开关位置调整到了拍摄模式转盘那边	neutral
翻转屏的最大优势就是进行更多特殊角度拍摄	positive
顺便说下和以及	neutral
比偏红偏假的色彩高感就不要太奢求了	negative
充电器插口是米国标准的大头	neutral
头脑一热就下手了	neutral
还有就是确实存在严重的屏偏绿的问题结果对焦和色彩让人失望	positive
操作够复杂的除了没有触摸屏以外	negative
主要是高清视频录制清晰度差长焦端光圈显得小了些	negative
这么密的小像素对焦点不行啊	negative
但另一台　没有这种情况	neutral
很赞	neutral
高感就不要太奢求了没有确实有点影响出片率	negative
可以把红色按钮	neutral
但是长焦是外变焦	negative
没有功能	negative
拿出去很唬人	neutral
实在是镜头没有办法处理	neutral
现在果断的入手了镜头	neutral
玩了半年就出掉了主要是边缘成像太差色散严重价格贵不少	negative
而远角端只有表现在取景器和想比	positive
对焦的速度上并不是很突出二是体型偏大了	positive
体积太大的确的背景虚化不太好做	negative
认到人脸后	neutral
机身缝隙稍大	negative
提高作品的成品率	neutral
液晶屏像素太低刚上手觉得操作特别困难	negative
特别是电池舱盖	negative
一口气买了	neutral
的我一会不敢超过不过感觉快门很涩	negative
电池使用寿命短不过该机器已经设计了外接电源的线孔比如确实有一定的进灰问题	positive
其实我也确实是业余的	neutral
底部材料没有改进	negative
一般都是原图直出	neutral
这是镜头太水的原因录像按钮	negative
月日下午免费试用活动中本人试用了套机	neutral
的我一会不敢超过液晶屏无法关闭盲拍	negative
这是本人这里最后一贴	neutral
失窃后就开始心痒痒了	neutral
配长焦机身偏小这个头的对焦性能并不好	positive
说老实话	neutral
镜头质量是高于其它厂的	positive
尤其是曝光锁定键但在大光圈长焦和闪光灯上还有不足	negative
不管从速度还是精确度上	neutral
会有影响光子到达第二层	neutral
便宜好用的自动镜头少快门声音比我想象的大得多	negative
我手持拍摄的出片率较低个对焦框太大了	negative
正面太滑拍出来白蒙蒙的	negative
特别是电池舱盖手柄突出部分和镜头对焦环之间的空间挤了点	negative
主要的问题	neutral
的测光准确	positive
晚上拍照比较吃力就是格式照片有点偏大本人用寸笔记本	negative
奥巴的/镜头也是个大块头现在这个样子怎么看怎么像镜头长倒过来似的	negative
毕竟是新款芯片	neutral
其次是那个主拨盘但对色彩的处理还不如众老厂经验丰富	negative
三围尺寸为	neutral
这里我只谈谈我在试用期间用的几点使用感受	neutral
一这些毛病不是独有的	neutral
主要是２８的广角镜头	positive
细节表現出色	positive
现在翻翻以前的照片	neutral
本人已经入手啦套机	neutral
就是快门声音不怎么样操作系统反映速度很慢	positive
屏幕太破了高感不好	negative
缺点吗	neutral
高像素的优势是可以缩片	neutral
隔老远也能拍特写	neutral
对焦性能的对焦系统相比前两代有了明显的提升	positive
人像肤色很现实里的人一样	neutral
手感不错	positive
比不上	neutral
作为迷恋的人	neutral
说明书第页也提到了三种可用快门线的型号	neutral
像的	neutral
值得鼓励	neutral
长焦端没有防震感觉机身的自动白平衡有点问题	positive
并且菜单的颜色经过了重新设计	positive
但驱动有点慢微距自动对焦较慢	positive
不想再等了	neutral
觉得电池续航能力很一般防尘不好	positive
机器本身拿在手里冰冰凉	neutral
画质还是可以的	positive
用的时候快门声音很怪重量重不少	positive
手感	neutral
经常会拉风箱天不好弱光下	neutral
这毕竟是趋势	neutral
这点进步大	neutral
但我没有在包装里面找到高清视频线	negative
景深预览键没有画面也惨不忍睹	negative
附上使用感受	neutral
外形手感感觉不如了	positive
最烦人的是不能全时手动色彩太假	positive
可以接受	neutral
的操控方式上	neutral
对于镜头自来旧的感觉看来可以修正了	neutral
不喜欢闪光灯的设计价钱不算低	negative
对焦速度慢切机身严防磕碰	positive
加了档位	neutral
正面太滑	negative
纠结于	neutral
尽管比还少一点	neutral
说说感受	neutral
对我够用了	neutral
外接闪光灯真丑感觉机身的自动白平衡有点问题	positive
还有就是确实存在严重的屏偏绿的问题	negative
感觉机身的自动白平衡有点问题	negative
就是掏多少钱给多少钱的东西	neutral
刚刚接触摄影	neutral
艺术效果拍摄时拖尾严重图像很硬	negative
并且如果同样的手抖	neutral
对焦速度是目前单电系统软肋长焦端没有防震	positive
在这一段空间中	neutral
配长焦机身偏小	negative
切了几个左边的对焦点	neutral
照片拍出来	neutral
拍的好像蒙了一层雾没有多次曝光功能	positive
和的手柄尺寸变化不大	neutral
和的电池不再通用	neutral
所以可以自动跟踪你拍摄物体的变化	neutral
奥巴的/镜头也是个大块头只是属于最严重的一类	positive
其实放电脑里	neutral
单次快门没有之前明显的两声了	neutral
以前用开到光圈	neutral
包顺丰	neutral
接下来的时间	neutral
还有品控问题反光板污点门个对焦框太大了	negative
也具备了的录像功能	positive
对焦慢所以让人感觉塑料感稍重	negative
以上的组合	neutral
翘了一边	neutral
只有一个外置接口没有多次曝光功能	negative
简直就在摸黑	neutral
聊胜于无	neutral
画面颗粒感较强而且定价太高了	negative
同样的镜头	neutral
非常实用	neutral
镜头方面也有不足的地方的工业设计到底怎么了	negative
现在多出来的锁定键做的太炒冷饭	positive
但是强劲的机能会弥补画质的不足	negative
在些次试用中本人按个人习惯使用了光圈优先自动曝光模式	neutral
取景器切换时候会有遮挡数据线都不配	positive
单反不是让你去撞的	neutral
光线暗的时候对焦拉风箱刚上手觉得操作特别困难	negative
试用几天体会	neutral
镜头陆续添置	neutral
变焦感觉有点慢哦有时候界面操作都会有些许延时现象	positive
说一下个人感受	neutral
数据线都不配单点对焦试了几张	positive
对器材的追求永远是摄影者不变的话题	neutral
不可能指望它会有多强	neutral
真的就是系统慢了点高感不好	negative
在肩屏的信息显示量上也不够丰富套头成像颜色偏冷	positive
增加了相位对焦取景器闪光灯接口	positive
具体参数锐意或京东商城相关页面上都有	neutral
照远景效果比许多机子差稳定性照电子快门线和遥控器差的多	positive
价格贵不少现在的屏幕裸露在外	positive
组合便利性强太多了	neutral
现在这个样子怎么看怎么像镜头长倒过来似的但实际试用发现对焦迟滞太严重	negative
可以通过显示屏放大	neutral
一般入这个头都是为了奶油一样的焦外	positive
首先说说	neutral
对焦的确非常非常慢四没有防抖	positive
机械快门线的确蛋疼没有防水防尘	negative
长焦端没有防震目前价位还是高于的	negative
寸万象素的液晶屏有点落伍了但是长焦是外变焦	positive
于是放下	neutral
小巧	neutral
如果不是太重的话	neutral
的对比感受	neutral
洞妖的片子色彩不容易溢出	positive
以下就是随拍的几张片子	neutral
没有任何提示和显示用的时候快门声音很怪	negative
在宾馆里面轻擦拭了一下	neutral
当时考虑过松下	neutral
这意味着只要你设置好了	neutral
广角端边缘锐度不行	negative
很多人觉得造型很怪异没有功能	negative
连唱带跳江南	neutral
陪我拍过无数电脑产品测试文章	neutral
当然	neutral
刚上手觉得操作特别困难广角端边缘锐度不行	negative
转盘和那个十字大按键有些容易误操作但是阳光下的远景分辨率说句不好听的就像手机拍的一样而且紫边也不小	positive
如果拍摄静物花花草草到此一游照什么的	neutral
图像很硬	negative
实用的摄影感受后期软件	neutral
很方便	neutral
其次是那个主拨盘的对比对焦显然没有的相位对焦快	negative
但似乎也把较差的边缘画质去掉了	positive
一般来说对焦还是很重要的一件事情	neutral
主要体现在分辨率	positive
而远角端只有此头焦外绿边十分严重	negative
说明他的电子设计和技术较低端机身蒙皮磨蚀严重	positive
无需三脚架也行	neutral
机身接缝紧密	positive
对强光源的处理不好密封不好等	negative
高感和画质不行	neutral
各家店货都不多	neutral
这头的对焦环可是它的机械性能又实在是不好	negative
附带的解软件解出来的效果非常差操作系统反映速度很慢	positive
纠结这点的人	neutral
而且使用速度狂慢我用的是苹果一体机可是定焦也太小气了	negative
而远角端只有快门触感变深	positive
实在想不通	neutral
比偏红偏假的色彩	negative
入手以及	neutral
基本上打开电源就能拍摄	neutral
手感操控性能画质已然全面落后还有品控问题反光板污点门	positive
但我宁可这样也不要糟糕的做工	negative
当时宣传对焦更快	positive
横着拍没有问题	neutral
但是感觉跟还是有一定差距的的电子技术确实不高不深	positive
像素重要吗	neutral
目前还没有配的既小巧又足够强大的闪光灯对焦速度偏慢	negative
眼传感器能省点电	positive
但是外挂电源毕竟影会影响的便携性一是太小完全不像是消费专业级数码相机的水平	negative
但驱动有点慢表现在取景器和想比	negative
那么值不值得入	neutral
操作的时候小里小气的便宜好用的自动镜头少	negative
别用一台过万的效果要求一台千多的机器	neutral
对焦叽叽的叫声让你觉得随时要坏虽然在强度上有些降低	negative
我是很满意了	neutral
键位设置不如全副方便小黑虽然部分焦段锐度跟不上	positive
要是就好了	neutral
的对焦的手感虽然少了的厚重感	negative
档案算蛮小的稍逊于单反的机械性能	positive
这头的对焦环主要是最小光圈只到	negative
但只有心无旁骛	neutral
添加了红色	neutral
的创见卡	neutral
虽然在强度上有些降低对焦速度慢这个完全不能和单反比啊	positive
我建议她买	neutral
不支持现在越来越流行的协议	neutral
想拍什么拿出来拍就是	neutral
千呼万唤始出来	neutral
镜头方面也有不足的地方	negative
画质高感低感全部都将杀得爹妈都不认识了	positive
但在大光圈长焦和闪光灯上还有不足我的就是最小的暗部噪点也清晰可见	negative
色彩太假这景深伤不起	negative
当然了	neutral
一会看片子您就知道了	neutral
以下是我入手后的试机体验以及通过这次购机获得的几点感受	neutral
以后再评价	neutral
同样用测试对焦现在的屏幕裸露在外	negative
现在的按键用起来不爽做工一般	negative
最大的问题是为小体积而小体积只有一个外置接口	positive
想问问为什么的照片这么小啊机身塑料感强轻	positive
作为吃光的芯片	neutral
外接闪光灯真丑但在大光圈长焦和闪光灯上还有不足	positive
	neutral
估计被黑了至少千	neutral
配合大光圈用着太舒服了	neutral
写速度是	neutral
这么密的小像素就是格式照片有点偏大本人用寸笔记本	negative
咔嚓咔嚓的	neutral
拍拍分钟以内的视频真的清晰无比	positive
持握手感不错	positive
便宜好用的自动镜头少接图的效果也不如	positive
但对色彩的处理还不如众老厂经验丰富玩了半年就出掉了主要是边缘成像太差色散严重	negative
大概元	neutral
相比之下	neutral
那感觉和效果是脚底抹油也赶不上主要是最小光圈只到	negative
就是一台没有电话功能问题是体积也没见小啊	negative
为了让已经买了的人和正在考虑买的人更了解这款机子	neutral
有得有失	neutral
稍有摄影经验的	neutral
我清还不行嘛	neutral
还原人像很好	positive
档案算蛮小的不过与相比的机身确实短了一些从左到右方向	positive
这个电子取景器非常有必要加上去	positive
等货源充足了	neutral
客观的说这机子画质还好	positive
参看了一下	neutral
毋庸讳言	neutral
功能保留了	positive
的对比对焦显然没有的相位对焦快机身手感一般	positive
下面上几张拍摄的片子	neutral
在晚上慢门小光圈	positive
如果一会儿担心对焦	neutral
真是台强制我不要乱按快门的好机器啊的工业设计到底怎么了	negative
看以后需要在入别的镜头吧	neutral
又让我心痒了	neutral
也很锐	neutral
人脸识别识别率木有手机或者强但是外挂电源毕竟影会影响的便携性	negative
所以都了	neutral
自身内存还有存储卡的速度有关	neutral
没有重量重不少	negative
快门触感变深除了没有触摸屏以外	negative
单次快门有很明显的两声	neutral
电池太渣	negative
就是成像似乎不像是微单的水平窃以为还是的软件功底差了	positive
但驱动有点慢除了价格比较高一些	negative
虽然后期能拉回来	neutral
快门	neutral
这个对于有些爱偷拍的朋友	neutral
如果能有对焦微调的对焦屏比较简单的感觉	negative
要是跌倒万人民币	neutral
试了一下高感	neutral
也不知道是的听腻了还是怎么着	neutral
应该还不错	neutral
价格贵不少对焦点有点集中	negative
后一半才是写入	neutral
大大方便了拍摄题材	neutral
配置一般	negative
顺便纪念过去七年里用拍的一些片子	neutral
只要你把镜头安装的机身上	neutral
没有机内除尘是个问题暗部对焦拉风箱	negative
整体感觉就是简洁	neutral
说一点个人抚摸感受	neutral
此头无疑在虚化上非常到位	positive
首先是那个和啤酒瓶子盖一样的模式转盘感觉机身的自动白平衡有点问题	negative
升级	neutral
手感操控性能画质已然全面落后没有多次曝光功能	positive
可是定焦也太小气了我发现的色彩非常干	positive
感觉开关拧到距离过长的对比对焦显然没有的相位对焦快	negative
对焦速度慢闪光灯没有闪光灯	negative
经我实际对比	neutral
删一张都要秒的等待时间	neutral
解放全副镜头	positive
但遵寻一分钱一分贷的定位	neutral
但强烈建议	neutral
下面是一些试拍的原片	neutral
导致无法进行连续拍摄没有闪光灯	negative
成像属于最好的一类	positive
略大于的尺寸	neutral
单反大家一般都主要关心的是机身操作	neutral
窃以为还是的软件功底差了	negative
较简单的操控要求	positive
发现对焦速度有所降低外观变丑了	negative
对焦速度偏慢存储速度慢	negative
用过一段时间	neutral
图象完全看不清楚	negative
但是	neutral
比如白平衡没有显示最大的问题是为小体积而小体积	positive
才能造成纯靠拍摄的洞妖续航力不错	positive
很锐利	neutral
重量重不少正面太滑	negative
可以上升很多	neutral
为什么照片这么小高感不好	positive
就是在拍凤凰树的微距的时候	neutral
不过和也是很完善	neutral
终于还是从官网定了一个	neutral
对不准的时候就换成点对焦也可以了	neutral
觉得电池续航能力很一般存储速度慢	negative
画质偏软拍出来的照片色调有些奇怪	negative
太强大了	neutral
一是是否开降噪	neutral
机身规格比其相近等級之与好上一些	positive
高感上面	neutral
色彩的话	negative
照片回放的时候	neutral
供有需要的摄友参考	neutral
而且很象没有录像就说下设计上的不足	negative
机身手感一般其实松下除了画质外	negative
也不好逃出紫边对焦速度是目前单电系统软肋	negative
只有从机顶看觉得造型怪异些锐度偏低	positive
不满的是反映速度感觉开关拧到距离过长	negative
明显敌不过	negative
由于已经上市半年多了	neutral
到周未才可以到外面拍下外景	neutral
所带来的重量压的不想再出去拍摄的时候	neutral
你的呢	neutral
用模式	neutral
不满的是反映速度对焦点选择不是很方便	positive
和的片子对比后发现	neutral
绝对的缺陷商品	neutral
操作够复杂的不过手感一般	positive
标配没有手柄	positive
刚发布的时候这个外观可以说没少招口水	positive
稳定性照电子快门线和遥控器差的多切机身严防磕碰	negative
同时最近对焦距离是	neutral
而且很象没有录像质量还不如以前的	negative
后面有人排队在准备试机	neutral
对焦速度偏慢以前很多人都说的机身差	positive
我在使用后感叹	neutral
电池太渣价钱不算低	negative
在使用液屏取景拍摄时	neutral
无论你是作为主机还是单反备机用	neutral
感觉和比起来全部都是玩具	neutral
比偏红偏假的色彩真的就是系统慢了点	negative
更比不上	neutral
个人觉得做工不如手柄突出部分和镜头对焦环之间的空间挤了点	positive
照惯例	neutral
不如做工好	negative
主要是高清视频录制清晰度差质量还不如以前的	positive
但在基本的锐利度表现现在多出来的锁定键做的太	negative
因为我觉得闪光灯离镜	neutral
只要能用个年	neutral
试用朋友后甚不喜	neutral
色彩不正及过渡不好色彩感觉没有原来的容易调整	negative
群里的朋友假如有要求可以私信发几张夜景人像	neutral
画质是相当不错	positive
快门速度提升明显	positive
通过这个帖子	neutral
新一代暗处色彩丢失可能是因为噪音太大导致严重降噪抹除了颜色左侧的接口布局有了改变	positive
对焦叽叽的叫声让你觉得随时要坏拍的好像蒙了一层雾	negative
我是从来不敢使用以上的感光度去拍人像的画质偏软	positive
会自动移到人身上	neutral
而且使用速度狂慢我用的是苹果一体机对焦太慢了	negative
本人并不感冒	neutral
真是小玩具一样	neutral
屏幕太破了似乎码率不够	negative
昨天又试了一下午最终决定买下	neutral
总体感觉是个好机器	neutral
色彩	neutral
对强光源的处理不好切机身严防磕碰	negative
取得了全画幅的重量优势	positive
感觉看不出噪点软件不太好使	negative
只不过应该会耗费不少电力吧对焦速度偏慢	negative
人家也是有运营成本的．	neutral
大学校园	neutral
只有从机顶看觉得造型怪异些其余的对焦点	negative
可你看它们的其它问题一大堆	neutral
闪光灯就算了	negative
奶系	neutral
希望有意入手的兄弟用得上	neutral
但那对焦速度我是受够了手感操控性能画质已然全面落后	positive
都让他有充足的空间去发挥自己的设计	neutral
这一设计既十分方便也很贴心	neutral
这只镜头配合起来就有点问题高感有说不如的	negative
拍娃党预算	neutral
和的比似乎就少了点相位对焦点锐度偏低	negative
系列的画质一般对焦太慢了	negative
总结	neutral
感觉机身的自动白平衡有点问题简单后期照片导出时还是很慢	negative
但在大光圈长焦和闪光灯上还有不足	negative
机械快门线的确蛋疼	negative
快门声在体验时最想让我吐槽的就是它的快门声了几个小按钮的感觉也是如此	positive
使用体验	neutral
窃以为还是的软件功底差了个人觉得做工不如	positive
那感觉和效果是脚底抹油也赶不上不过对大光比的控制方面明显不如全副	positive
现在多出来的锁定键做的太但在大光圈长焦和闪光灯上还有不足	negative
先看看图	neutral
看来担心是多余的本人手掌大小中等	neutral
但是这回拿到	neutral
的对焦方式是对比度对焦	positive
数据线都不配导致无法进行连续拍摄	negative
尤其是高感的表现	neutral
松下出来的图片的比对度的确有点不够亮度还是偏低	negative
主要是高清视频录制清晰度差问题是体积也没见小啊	positive
拍出来的照片色调有些奇怪但实际试用发现对焦迟滞太严重	negative
入手大概拍了不到的快门就准备出手换了	neutral
只是	neutral
对焦速度一般操作系统反映速度很慢	negative
可用范围宽	positive
套装便携性非常好	positive
对于有人说它是塑料机身炒冷饭	negative
在广角和中焦端使用时就比较轻松了	neutral
简单后期照片导出时还是很慢尤其是曝光锁定键	negative
再闪几次	neutral
使用心得与大家共勉	neutral
于是一用就是七年	neutral
如果朋友担心这机子停产后买不到电池	neutral
不喜欢闪光灯的设计	negative
完全超越和全是偏黄的	neutral
拍出人物的皮肤较硬没有内闪	positive
手感操控性能画质已然全面落后全副镜头在上广角损失严重	negative
顺便吐槽这几个新出的镜头松下出来的图片的比对度的确有点不够	negative
色彩未必比差	positive
已导入的不再导入	neutral
其画质细腻饱满明暗及色彩过渡也好于	positive
手感操控性能画质已然全面落后尤其是曝光锁定键	positive
图象完全看不清楚我手持拍摄的出片率较低	negative
对相机的感觉不可能准确	neutral
使用档	neutral
购买历程使用感受及高感样片	neutral
但是阳光下的远景分辨率说句不好听的就像手机拍的一样而且紫边也不小可是定焦也太小气了	negative
六的手动对焦环是假的是对焦环不是变焦环它的手动变焦环很爽像素密度太密了	positive
我所在的小城关于器材的更新也迟于大城市	neutral
光学取景器聊胜于无只是控制和手感恐怕没有这么舒服	negative
的镜头是新的	neutral
主要是高清视频录制清晰度差	negative
从屏幕上看	neutral
使用了新的液晶屏	neutral
主要是因为色散控制不好的原因	negative
光学取景器聊胜于无对焦速度是目前单电系统软肋	positive
如果快些会更好	neutral
说实话在论坛上看到对它的评论都是褒贬不一	neutral
抛开其他降噪技术	neutral
迅捷准确的对焦	positive
当然手感很象还不错	positive
又只有万左右的预算	neutral
手感操控性能画质已然全面落后价钱不算低	positive
不过感觉快门很涩色彩的话	positive
画质偏软液晶屏无法关闭盲拍	positive
外盖分成了三部分高速卡帮助不大	positive
我想很难吃得消	neutral
我觉得的机身手感很不理想对焦速度慢这个完全不能和单反比啊	negative
正面太滑手柄也太小	negative
其实拍片子的时候挺好用的	positive
/的快门大家都非常郁闷表现在取景器和想比	positive
尽管比要重许多	neutral
我也会陆续通过回复功能发一些我用拍的片子	neutral
电子取景器有时滞发现对焦速度有所降低	positive
在这个方面	neutral
因此毫不犹豫官网下单	neutral
肩屏显示的信息很多和开头的机器甚至开头的机器都不相符的塑料卡口	negative
简单把玩了一下	neutral
摄像画质好过同时期的的半幅机新上市的那块东芝的感光元件听说更强	positive
窃以为还是的软件功底差了液晶屏无法关闭盲拍	positive
比开关要方便相对于来说	neutral
特别是电池舱盖没什么用处	negative
电池不够用底部材料没有改进	positive
更明亮	neutral
我以多的价格卖出去了	neutral
俺用了半年多了	neutral
配长焦机身偏小基本没用	negative
高成像的质量比卡片机好太多	positive
外盖分成了三部分这景深伤不起	positive
也是很多爱好者喷它的理由之一	neutral
使用感受	neutral
说说感受吧	neutral
但在自动对焦操控感受上还存在一定差距但在大光圈长焦和闪光灯上还有不足	positive
中央五个对焦点很暴力窃以为还是的软件功底差了	negative
听着挺爽	neutral
有时在长焦段会有拉风箱现象的我一会不敢超过	negative
所以我最后想说的是别用单反的性能要求一台微单	neutral
不过改了个名字叫自动全景然后这机子长焦端应该没有等效那么长	neutral
下面就和大家分享一些相机的试用感受	neutral
如果没有上述需求	neutral
高速连拍的第一连拍是和	positive
镜头也采用了工程塑料	neutral
就是格式照片有点偏大本人用寸笔记本拍的好像蒙了一层雾	negative
色泽与可视角表现也佳	positive
虽说不太认同感动家的机身设计价格对我来说也贵了	negative
广角时挡一点没什么大不了的	neutral
肩屏显示的信息很多和的高感成像质量相比较而言就有些惨了	negative
质量还不如以前的全副镜头在上广角损失严重	negative
单点对焦试了几张	negative
除了价格比较高一些	negative
毕竟有点小贵	neutral
也有紫边拍出来的照片色调有些奇怪	negative
证实它的除尘功能不是忽悠人的	positive
显得有些不规整	neutral
外观既没有时尚	negative
所以这个头用好需要肌肉记忆	neutral
拍人都逼我对焦重构图啊	neutral
机械快门线的确蛋疼寸万象素的液晶屏有点落伍了	positive
觉得电池续航能力很一般玩了半年就出掉了主要是边缘成像太差色散严重	negative
镜头素质比较高	positive
机身轻小后的缺陷装个都觉得头重脚轻但是强劲的机能会弥补画质的不足	positive
暂时还不够丰富的系统看着取景器里的对焦点从模糊清晰模糊清晰的过程的确有砸机冲动	negative
怎么看	neutral
除了没有触摸屏以外闪光灯就算了	positive
前者的功能还是很有现实意义的	neutral
机身手感一般功能不如	negative
用过朋友的加小白	neutral
不该犯低级错误	neutral
手动对焦有外接闪光灯真丑	negative
晚上拍照比较吃力长焦端光圈显得小了些	negative
外观做工	neutral
相对自带的显示屏好太多了	positive
手感操控性能画质已然全面落后对焦真的没什么优势	positive
但强大的电子技术让其用户可以享受一些其他用户没有的新技术	positive
什么机子都可以借用	neutral
我个人完全看不出有什么差别	neutral
特别是时	neutral
按键按起来啪啪响	negative
这个我个人是非常喜欢的	neutral
感觉开关拧到距离过长的工业设计到底怎么了	positive
是比好太多了	neutral
系列的画质一般机器内闪只有	negative
不等了	neutral
拍出来白蒙蒙的肩屏显示的信息很多	negative
本人是带着去的	neutral
在试了下	neutral
软件不太好使充电感觉不是很方便	positive
比如白平衡没有显示这是镜头太水的原因	negative
速度奇慢	negative
图像处理器	neutral
希望机器耐操点	neutral
直到电量用尽开不了机	neutral
份量也不轻	positive
直接设置成闪光灯关闭	neutral
这机身够我用到坏了	positive
增加了相位对焦取景器闪光灯接口	positive
而且很象没有录像另外高感也差很多	negative
深感欣慰	neutral
比如确实有一定的进灰问题的电子技术确实不高不深	negative
那往往是拍摄距离与空气的原因	neutral
照远景效果比许多机子差左侧的接口布局有了改变	positive
你会发现真心不错	neutral
觉得电池续航能力很一般就一姐夫机的大小	negative
用转接要好很多但又没有了自动对焦我最不满意的是那个删除键	positive
高感不好这么密的小像素	positive
裁切画面后	neutral
远超松下	neutral
高感有说不如的出来的片子更糟	negative
无奈	neutral
估计有些小店会把价格降下来一些	neutral
本人做的第一件事就是恢复出厂设置	neutral
它的功能上的确有些不足录像按钮	positive
有时候界面操作都会有些许延时现象	negative
默认锐度和色彩鲜度都一般	neutral
	neutral
外观设计风格上基本保持了一致	neutral
特别是手感真好	positive
和边缘对焦点对焦的速度和精准度和没有什么差异	neutral
感觉不错	neutral
暗处也是不含糊	neutral
不管是点测光	neutral
开启清晰影像缩放后	neutral
但比弱一些	neutral
/及分不清型号小若干	neutral
我痛恨后期再去剪裁	neutral
不明白怎么回事	neutral
尤其是俯拍实时取景	neutral
对这款功能几乎完善的机子	positive
套头成像颜色偏冷左侧的接口布局有了改变	negative
中央对焦点暗光下对焦稳准快	positive
买了第一个单反套装	neutral
让小弟对于升級机身的声音开始越来越大	neutral
还有就是确实存在严重的屏偏绿的问题的工业设计真是倒退了三十年	positive
和老头子去了相机店	neutral
老鸟别跟我提那什么药对焦上什么的	neutral
玩了半年就出掉了主要是边缘成像太差色散严重就只是怪的色彩	negative
对焦慢结果对焦和色彩让人失望	positive
为什么照片这么小光线暗的时候对焦拉风箱	negative
我发现的色彩非常干不过与相比的机身确实短了一些从左到右方向	negative
体积太大虽说不太认同感动家的机身设计	negative
只能通过波轮改变快门速度	neutral
就是对焦前先来回抽一下让人蛋疼	negative
直接出片机内处理锐度过头了点	negative
胜档	neutral
不然不是很好用	neutral
让那些用的女士双臂平伸端着手感很差的克重物显得那么滑稽可笑这只镜头配合起来就有点问题	negative
可以在后期处理上有更多的余地	neutral
只有一个外置接口没有闪光灯	positive
我狠满意	neutral
但体积不小	negative
尤其是的	neutral
理论上半秒钟就可以写入完成	neutral
三我用卡	neutral
真的狠不错	neutral
如果能便宜个会更好	neutral
干嘛非得追求全金属呢	neutral
完全干净的白墙是对不上的就如同你对天空对焦一样	neutral
结果对焦和色彩让人失望且目前售价也略高	negative
主要的原因其实不外乎三个	neutral
没有多次曝光功能左上角的拨盘看上去仍然很幼稚	negative
手感都没啥可说的	positive
只是控制和手感恐怕没有这么舒服现在这个样子怎么看怎么像镜头长倒过来似的	positive
加镜价格苏宁镭射丰泽百老汇天祥永成报价都是	neutral
手指就摸眼镜一鼻子灰	neutral
在微单群体里虽是偏贵但它的确完胜极大部分微单	neutral
也没能带上三脚架	neutral
感光元件仍然是使用了/英寸规格的	neutral
在试用的屋子里也有	neutral
机内测光容易出错导致过曝我的就是最小的暗部噪点也清晰可见	negative
但色彩略差于也是如此的设计	positive
不少人又开始说我业余了	neutral
显示屏上会出现类似锐化过度的现象	neutral
刚上手觉得操作特别困难在暗处对焦边缘对焦点无力	positive
做工一般但是像素比较低现在觉得我完全不需要高像素这点下面我会解释	positive
机身蒙皮磨蚀严重但是阳光下的远景分辨率说句不好听的就像手机拍的一样而且紫边也不小	negative
声称为原厂电池	neutral
体积太大还有就是确实存在严重的屏偏绿的问题	negative
所以设计理念上不高明还有品控问题反光板污点门	negative
感觉锐度	positive
昨天在大拇指广场摸了真机	neutral
那就更好了	neutral
换系统是下下之策	neutral
但第一感觉不如的	neutral
寸全屏对比看能看出区别	neutral
没有经过任何处理	neutral
我就知道	neutral
和的高感成像质量相比较而言就有些惨了没有确实有点影响出片率	positive
因为实在差太远了	neutral
不敢乱说	neutral
可以点击照相机图标进入拍摄	neutral
宾得毫不吝啬的给予了足以傲视同级机身的视野率	positive
可以掌握了抓拍的窍门了	neutral
来说说初步体会吧	neutral
暂时还不够丰富的系统	negative
但是对快速移动物体	neutral
功能不如其余的对焦点	negative
但在大光圈长焦和闪光灯上还有不足不过与相比的机身确实短了一些从左到右方向	negative
但是对于抓拍来说	neutral
但是便携性较差景深预览键没有	negative
但对色彩的处理还不如众老厂经验丰富几个小按钮的感觉也是如此	positive
机身塑料感十足个人觉得做工不如	negative
尺寸能更小就最好了	neutral
对焦点有点集中只是开电池舱盖和卡舱盖的时候能明显感觉到塑料的做工	negative
但是上了多少有点点小重	neutral
也走过不少弯路	neutral
小黑虽然部分焦段锐度跟不上因为经常看到有人说的声音一塌糊涂	positive
但我几乎不用	neutral
谁用谁知道	neutral
但那对焦速度我是受够了光线暗的时候对焦拉风箱	negative
快门声在体验时最想让我吐槽的就是它的快门声了	negative
万像素觉得万是飞跃	neutral
就这些感受	neutral
现在手里有高感确实很牛	positive
电池不够用键位设置不如全副方便	negative
而且很象没有录像中央五个对焦点很暴力	negative
所以在全质量格式下卡也仅能储存约张左右的图像	neutral
送的加起来应该差不多也值个百来块吧	neutral
触摸屏	neutral
像素密度太密了外接闪光灯真丑	negative
虽然位数	neutral
对焦太慢了	negative
配合键使操控能力提升	positive
变焦感觉有点慢哦	negative
节省你的体力	neutral
要照高速移动的物体或者活跃的动物基本上是不可能	neutral
对焦效果也和手持稳定性有关	neutral
我使用了年半	neutral
但实际试用发现对焦迟滞太严重不过感觉快门很涩	negative
机身塑料感十足说明他的电子设计和技术较低端	negative
但在自动对焦操控感受上还存在一定差距色彩太假	negative
稍逊于单反的机械性能但是像素比较低现在觉得我完全不需要高像素这点下面我会解释	positive
颇有单反的风格	neutral
光学取景器	neutral
对焦速度慢切机身严防磕碰	positive
对焦距离比之前看介绍的更大	neutral
对于有人说它是塑料机身其次是那个主拨盘	positive
色彩灰暗	negative
其余的对焦点色彩不够鲜艳	positive
还是上了	neutral
同样用测试对焦最烦人的是不能全时手动	positive
它们的电池	neutral
现在的屏幕裸露在外先对焦后构图速度太慢且容易焦点偏移	positive
它相机里电池自行放电由来已久	negative
不知道能用到不	neutral
艺术效果拍摄时拖尾严重色彩太假	positive
小弟伤不起	neutral
对焦的确非常非常慢拍出来的照片色调有些奇怪	positive
我预感到要出新品	neutral
真的是给了我惊喜	neutral
六的手动对焦环是假的是对焦环不是变焦环它的手动变焦环很爽塑料感强	positive
应该是全方位的相机	neutral
且目前售价也略高	negative
对对焦点的明暗反差要求比较高液晶屏无法关闭盲拍	negative
使用小时后重量和体积的优势比巨大了	positive
充电器带了个插头用来适应不同国家地区	neutral
可以在相机上安装网上的各种小插件	neutral
不过感觉快门很涩	negative
画质出色基本可以肯定	positive
低感下画质相当干净各	positive
表现优秀	positive
洞妖拍了张	neutral
操作和相比	neutral
与之前的万像素	neutral
底部材料没有改进在暗处对焦边缘对焦点无力	positive
快门声音比我想象的大得多	negative
明显感觉比它有型多了	neutral
不急	neutral
镜头也用过只．	neutral
这个设定在新的单反相机上都有配置	neutral
甚至	neutral
是全画幅的	neutral
在键位设置方面	neutral
港币送卡登仕保护贴副厂电池不值钱的小包小小三脚架最多值块	neutral
手感操控性能画质已然全面落后	negative
对于我这个业余爱好者拍着玩来说入手哪个都够用了	neutral
小五就成打酱油的总体上给我的感觉这套系统对焦性能和差不多	negative
但是没有想象中那么严重	neutral
但画质比不知差多少	positive
的产品	neutral
现在深深感到取景器可以退休了	neutral
比如确实有一定的进灰问题充电感觉不是很方便	negative
哈哈	neutral
实用性很好	positive
电子取景器有时滞很多人觉得造型很怪异	negative
图象完全看不清楚玩了半年就出掉了主要是边缘成像太差色散严重	negative
新机开封快门	positive
液晶屏无法关闭盲拍对焦速度慢这个完全不能和单反比啊	negative
但是便携性较差	negative
它在广角端可以达到	positive
电子取景器有时滞	negative
看着取景器里的对焦点从模糊清晰模糊清晰的过程的确有砸机冲动和的高感成像质量相比较而言就有些惨了	negative
取景器可以外接镜片	neutral
摄像功能	neutral
主要是拍摄静态人物照片	neutral
和的比似乎就少了点相位对焦点	negative
对焦速度还稍微跟不上因为经常看到有人说的声音一塌糊涂	positive
洞妖的明显要慢于的而腾龙出片我个人感觉比较像一个数码记录图像	negative
但是外挂电源毕竟影会影响的便携性对对焦点的明暗反差要求比较高	positive
放大寸或寸应该没有什么问题	neutral
的机身依旧采用工程塑料现在的按键用起来不爽	positive
带出去没面子	neutral
感觉上都不如一节的充电电池大	neutral
塑料前脸仍然没有升级成合金材料肤色偏黄	negative
但我却很喜欢真实的色彩	negative
而远角端只有我是从来不敢使用以上的感光度去拍人像的	negative
键位设置不如全副方便体积小	negative
在回看照片时按键时	neutral
就是快门声音不怎么样我觉得的机身手感很不理想	negative
就是调整对焦范围的	neutral
缩光圈认真的拍图片拍锐了	neutral
中端王者	neutral
供参考	neutral
使用过夜景模式	neutral
以我的工作场景	neutral
吐槽完毕	neutral
全副镜头在上广角损失严重对焦太慢了	positive
胜在机身质感佳	positive
有时候界面操作都会有些许延时现象色彩不够鲜艳	positive
很质感	neutral
暗部对焦拉风箱如果能忍受它缓慢的存储速度的话	positive
看着取景器里的对焦点从模糊清晰模糊清晰的过程的确有砸机冲动	negative
缺点	neutral
实际使用的感受	neutral
缺点是体积略大直接出片机内处理锐度过头了点	positive
但是很准	neutral
但则更进一步	neutral
体积小只是开电池舱盖和卡舱盖的时候能明显感觉到塑料的做工	positive
高感就不要太奢求了机身缝隙稍大	positive
网上搜索多得很	neutral
稳定性好很多	neutral
再淘汰之前我首选的是	neutral
现在多出来的锁定键做的太做工一般	negative
但是感觉跟还是有一定差距的但是长焦是外变焦	positive
当然预算够还是直接上吧	neutral
俺不重复了	neutral
我这算不算传说中的快门事件	neutral
没有防水防尘色彩不正及过渡不好	positive
有卖家打出薯片/	neutral
用惯了光学取景器	neutral
小五就成打酱油的寸万象素的液晶屏有点落伍了	positive
其实只要把阻尼做好了根本不必离那么远	neutral
像质锐利	positive
经常会撸一把	neutral
期待是因为感觉终于有一部新的传感器来代替原来的万的神之传感器了	neutral
上周末拿着拍了一场婚礼	neutral
才有这个功能	neutral
但我宁可这样也不要糟糕的做工电子取景器有时滞	positive
小巧的高画质	positive
静物和人物的摆拍	neutral
没有任何提示和显示拍出来白蒙蒙的	positive
很多人觉得造型很怪异而且定价太高了	negative
应该不可能假货仿货	neutral
没有多次曝光功能取景器切换时候会有遮挡	negative
就说下设计上的不足简单后期照片导出时还是很慢	positive
的电子技术确实不高不深用过/系统的人绝对会受不了的触摸屏	negative
腾龙锐度之高是有目共睹的	positive
机顶仍然带热靴	neutral
计分	neutral
视频最高帧率又只有根据国内视频制式不同的相机分和版	neutral
轴了防抖	neutral
但用起来才发现	neutral
虽然增加了接口	neutral
感觉看不出噪点	negative
关键是没有了手柄没有了眼平取景器	neutral
优异的画质加之充分发挥镜头的视角	positive
原来一直担心由于机身比较短会给大拇指操作空间带来影响	positive
也没试	neutral
天冷是一方面	neutral
再说便携性不仅仅是体现在个头上	neutral
功能由于中国的国情原因功能无法使用	neutral
没有闪光灯炒冷饭	negative
尤其是因为功能项目多	neutral
不得不说	neutral
个人觉得做工不如快门声在体验时最想让我吐槽的就是它的快门声了	negative
六的手动对焦环是假的是对焦环不是变焦环它的手动变焦环很爽	negative
谁让自己懒了	neutral
也是边缘对焦不如中心对焦	neutral
不满的是反映速度这么密的小像素	positive
以致我第一次按下快门时惊异了两秒种才回过神来	neutral
可就不是那么回事了．	neutral
触摸屏的使用	neutral
相比较的快门让人着迷多了	positive
操作更加便捷	positive
请问各位前辈学长们	neutral
的体型很小	positive
价格对我来说也贵了也有紫边	positive
但是镜头对焦的噪音如果太大比如我用的/	neutral
使用了一段时间	neutral
刚用过	neutral
拍了几组片子	neutral
价格相对昂贵基本没用	positive
只是开电池舱盖和卡舱盖的时候能明显感觉到塑料的做工	negative
以前很多人都说的机身差只不过应该会耗费不少电力吧	positive
的对比对焦显然没有的相位对焦快边缘对焦还是比较容易拉风箱	negative
就是紫边太严重夜景手持真的很吃力	negative
数据线都不配试过边缘对焦	positive
有时在长焦段会有拉风箱现象最烦人的是不能全时手动	negative
没有任何提示和显示	negative
安心了	neutral
这有点坑爹	neutral
相对也有多种记录方式	neutral
拧动对焦环	neutral
画质着实不错	positive
四款机器对焦点的数量网上都有数据	neutral
廋廋小小的	neutral
真是个好机子啊	neutral
但对色彩的处理还不如众老厂经验丰富目测对焦速度慢于	negative
操控缩水夜景手持真的很吃力	positive
而且使用速度狂慢我用的是苹果一体机在暗处对焦边缘对焦点无力	negative
至少/已经过去了	neutral
配置一般只不过应该会耗费不少电力吧	negative
但是屏幕实在不堪入目白平衡只能菜单调	negative
也没专业	negative
官方数据指标上>>>	neutral
也贵	neutral
长焦端没有防震如果能忍受它缓慢的存储速度的话	positive
完全没有发挥半透镜优势的对焦张/秒的连拍速度但对色彩的处理还不如众老厂经验丰富	positive
这点对有相机想入的朋友是一个好的消息	neutral
操作够复杂的高感不好	positive
完全没有发挥半透镜优势的对焦张/秒的连拍速度明显敌不过	positive
但色彩油润的多	positive
	neutral
确实有实际价值	neutral
这是镜头太水的原因	negative
视野明亮细腻	neutral
任何人操作同一款设备的感受都会有些差异	neutral
但是没有了灰尘的烦恼	neutral
毕竟的和定焦头太迷人了	positive
镜头体积增大	neutral
普通场合也还够用	neutral
以及少量人像	neutral
直出很好	positive
就完美了	neutral
确实还不错	neutral
变焦感觉有点慢哦有时候界面操作都会有些许延时现象	negative
左肩顶部的开关设计可以说是新单反产品的标准样式了	neutral
的工业设计到底怎么了	negative
配置一般对焦速度慢	negative
但是强劲的机能会弥补画质的不足对焦点选择不是很方便	positive
顺便说下价格	neutral
对焦真的没什么优势这么密的小像素	negative
必须合焦后才能按下快门	neutral
稍微玩了一下	neutral
也有点厚	neutral
附带的解软件解出来的效果非常差艺术效果拍摄时拖尾严重	negative
相信不久的将来	neutral
防抖没有想像中管用新一代暗处色彩丢失可能是因为噪音太大导致严重降噪抹除了颜色	positive
最出色色彩还原的出错率最低	positive
键	neutral
的宽容度不错	positive
轻的可以水上漂	neutral
空手而归	neutral
那感觉和效果是脚底抹油也赶不上因此背景的虚化不足	positive
其中至少/是用内闪的	neutral
保证焦点准确对焦	neutral
而且我也不太重视以上的高感表现	neutral
优点	neutral
速度奇慢顺便吐槽这几个新出的镜头	negative
高感不好没什么用处	negative
图象完全看不清楚景深预览键没有	positive
我们要问	neutral
当你选好一个题材	neutral
但是屏幕实在不堪入目但是阳光下的远景分辨率说句不好听的就像手机拍的一样而且紫边也不小	positive
没有确实有点影响出片率这么密的小像素	positive
追焦时我常用区域自动对焦	neutral
是做工厚实	positive
构图也不难	positive
人物的皮肤还有些发青的感觉	neutral
取景器切换时候会有遮挡这是镜头太水的原因	negative
当前的速度已经很浪费快门了	neutral
单点对焦试了几张只是开电池舱盖和卡舱盖的时候能明显感觉到塑料的做工	positive
当然这也许是白平衡的问题的非常差	negative
质量还不如以前的白平衡	positive
四没有防抖现在这个样子怎么看怎么像镜头长倒过来似的	negative
外接闪光灯真丑手感操控性能画质已然全面落后	positive
形式比较好	neutral
接图的效果也不如最不满意的也就对焦系统了	positive
夜景手持真的很吃力这头的对焦环	negative
全高清视频拍摄功能等众多亮点再加上元区较高的性价比	positive
对焦慢其余的对焦点	positive
单手操作方便	positive
呵呵	neutral
可能是用惯了的原因	neutral
肩屏小了些屏幕用这么差的材料	positive
效果还真是不错	positive
开机慢大概秒以上	negative
还有个美肤的功能	neutral
开机慢大概秒以上操作系统反映速度很慢	negative
盼分解	neutral
够用就好	neutral
这对于宾得之前饱受非议的弱光下和人造光下跑焦的和用户来说	neutral
色彩太假连续自动对焦的速度是最差的	positive
现在又想回	neutral
白平衡不过与相比的机身确实短了一些从左到右方向	positive
在暗处对焦边缘对焦点无力机身缝隙稍大	negative
转盘和那个十字大按键有些容易误操作广角端边缘锐度不行	positive
首先是那个和啤酒瓶子盖一样的模式转盘	negative
手感操控性能画质已然全面落后	negative
实际使用还是灰常靠谱的	neutral
感觉这个反光板要掉下来一样	neutral
目前只有也开放这项技术在机身上	neutral
提高了握持手感和防滑性能	positive
这种气温下一块原装电池随便用个天没问题	neutral
画质达到了全画幅的水准	positive
有个固件叫	neutral
就是紫边太严重机身轻小后的缺陷装个都觉得头重脚轻	positive
个人觉得做工不如但便携机在图像质量上总是稍欠缺一点还有不能换镜头局限了拍摄题材	positive
不喜欢闪光灯的设计就感觉出来的片子更糟	negative
总的来说用来拍人像肤色怪怪的	negative
作为一个业余爱好者	neutral
白平衡需要不停的去试着拍	neutral
照远景效果比许多机子差二是体型偏大了	negative
到手时间不短	neutral
的电子技术确实不高不深缺点是体积略大	positive
其功能已大都能满足我目前的使用要求	positive
经不起裁剪	neutral
也舍不得饼干	neutral
可是定焦也太小气了就说下设计上的不足	positive
感觉有点向靠近	neutral
总结和必须双机器	neutral
也让我开始喜欢上摄影	neutral
外盖分成了三部分刚上手觉得操作特别困难	negative
拍的好像蒙了一层雾白平衡只能菜单调	positive
不如做工好的对焦屏比较简单的感觉	positive
快门声音比我想象的大得多对焦速度偏慢	negative
加上几天以来的思考	neutral
在弱光环境下	neutral
对焦的确非常非常慢	negative
宾得做了很多消光措施	neutral
都是模式局部测光顺光拍摄快速对焦	neutral
这个功能的意思是按快门键的时候是选择释放快门优先还是合焦优先	neutral
压缩比有些点	negative
稍逊于单反的机械性能这景深伤不起	negative
高速卡帮助不大而腾龙出片我个人感觉比较像一个数码记录图像	positive
我还是需要感受一下	neutral
几个小按钮的感觉也是如此虽然在强度上有些降低	negative
只是控制和手感恐怕没有这么舒服做工一般	positive
画面颗粒感较强尤其是曝光锁定键	positive
其实我并不是极致便携的追随者	neutral
这类足够了	neutral
后来被的高像毒蛊惑	neutral
暂时还不够丰富的系统它的功能上的确有些不足	negative
塑料感强对焦的速度上并不是很突出	positive
就是的色散比重引起的防抖没有想像中管用	positive
的连拍和出色的机震控制也给我留下了很深刻的印象	positive
这个头的对焦性能并不好就是色彩比较淡	negative
要说不足	neutral
操作系统反映速度很慢可能握持上不是太舒服	negative
有些不可思议	neutral
因此背景的虚化不足但体积不小	negative
当然这也许是白平衡的问题它相机里电池自行放电由来已久	negative
它的功能上的确有些不足对焦的速度上并不是很突出	negative
不说瞎话	neutral
明显敌不过总的来说用来拍人像肤色怪怪的	positive
但驱动有点慢机背液晶屏竟然是塑料的	negative
你都可以清晰的看见紫边	neutral
手感操控性能画质已然全面落后对焦点选择不是很方便	positive
如果使用实时取景拍摄的话	neutral
感觉成幅人了	neutral
或者放在一个稳定的地方	neutral
一是太小完全不像是消费专业级数码相机的水平	negative
安装好镜头电池和储存卡后	neutral
从个人觉得按重要性	neutral
无法体验实际压手感	neutral
说说的感受吧	neutral
不管如何	neutral
液晶屏可以全角度旋转	positive
手感操控可玩性都具备了	positive
连续自动对焦的速度是最差的玩了半年就出掉了主要是边缘成像太差色散严重	positive
看了港台摄友的拍摄感受	neutral
海鸥入的门	neutral
比看照片帅一点	neutral
档案算蛮小的让那些用的女士双臂平伸端着手感很差的克重物显得那么滑稽可笑	positive
到这里我想小黑和应该不只是一个超声波马达的问题了	neutral
电池不够用	negative
如果是静静心心拍点东西的话	neutral
焦点准确	positive
参数丰富	positive
画面也惨不忍睹这头的对焦环	negative
表现在取景器和想比	negative
对对焦点的明暗反差要求比较高另外高感也差很多	positive
拧到位置继续往下拧就要松开手再拧一次	neutral
而在时代	neutral
由于使用场景的不同	neutral
入选机型	neutral
外置电子取景器	neutral
画质偏软感觉机身的自动白平衡有点问题	positive
那感觉和效果是脚底抹油也赶不上不喜欢闪光灯的设计	positive
机子太小太轻先对焦后构图速度太慢且容易焦点偏移	negative
没有的感觉好	neutral
你怎么看呢	neutral
对焦速度慢这个完全不能和单反比啊	negative
毕竟定位区别	neutral
就是对焦前先来回抽一下让人蛋疼寸万象素的液晶屏有点落伍了	negative
使用机身背布的八方向功能转盘调整对焦时响应速度快捷	positive
微单意味着就是换镜头	neutral
这种更偏向玩物	neutral
而且使用速度狂慢我用的是苹果一体机白平衡只能菜单调	positive
试用的初步感受	neutral
背屏改变为可以度旋转的形式	positive
是数码机就一定有	neutral
这个需要另外购买	neutral
其次是那个主拨盘的非常差	positive
红色的三角裤很精神	neutral
底感差	negative
价格贵不少为什么照片这么小	positive
甚至还略有不如	neutral
刚拿到	neutral
　１６００至少　４００可用	neutral
底感差玩了半年就出掉了主要是边缘成像太差色散严重	positive
因为没有反光板的起落	neutral
按键按起来啪啪响快门声音比我想象的大得多	positive
对焦点能否落到眼睛上常常决定一张片子的成败	neutral
叹息老师等朋友推荐	neutral
相机并没有像市场上大部分无单相机一样因为体积缩小而在手感上有任何缩水	neutral
言归正传	neutral
居然带简单的手动模式	positive
画质偏软	negative
说说感受	neutral
显示屏跟电脑显示的接近	neutral
我会立马入手一台	neutral
很多朋友说	neutral
细节较多液晶屏像素太低	negative
放在上	neutral
与配合很适合一镜走天下	neutral
实际上我对的对焦已经非常满意了	positive
也不好逃出紫边电池续航能力一般	negative
/的快门大家都非常郁闷连续自动对焦的速度是最差的	negative
但是外挂电源毕竟影会影响的便携性	negative
快门机构也是和有差异的	neutral
有时在长焦段会有拉风箱现象因为之前的的画质堪称垃圾	negative
整体感觉就是一入门机的样子做工一般	negative
贵重	neutral
驱动不比差	positive
连拍够用了	positive
配长焦机身偏小当然这也许是白平衡的问题	negative
手柄突出部分和镜头对焦环之间的空间挤了点个对焦框太大了	positive
所以很多朋友可能有意无意的危言耸听了	neutral
用过	neutral
手动对焦更慢一些防抖没有想像中管用	negative
新购入柯达一台	neutral
支持取景器	positive
刚上市的时候	neutral
为什么记录格式时一定要同时记录呢	neutral
持握感提升明显	positive
手感一流	positive
以前很多人都说的机身差和的比似乎就少了点相位对焦点	negative
如果是用	neutral
和功能真不错	positive
对焦很快	positive
对焦叽叽的叫声让你觉得随时要坏但是屏幕实在不堪入目	positive
万象素的相机屏	neutral
首先	neutral
画质没有什么出彩的地方现在的屏幕裸露在外	negative
手感更好	positive
在这方面可以说是相对负担比较小的	neutral
系列的画质一般但那对焦速度我是受够了	negative
另外高感也差很多	negative
就是必须考虑拍摄者的操控需要	neutral
对于自动对焦	neutral
肩屏显示的信息很多对焦速度慢这个完全不能和单反比啊	negative
然后拍了两张	neutral
洞妖比其他牌子的单电大一些光学结构摆在那里的	neutral
以及价钱一直没啥松动的	neutral
直接出片机内处理锐度过头了点奥巴的机器握感都不好	negative
不比机器来的效果差	neutral
挂一天	neutral
存储速度慢对强光源的处理不好	positive
依旧延续了系列机器的经典外观	positive
各有所爱	neutral
照远景效果比许多机子差的手感虽然少了的厚重感	negative
而远角端只有对焦点有点集中	positive
高清视频的自动对焦即使用蔡司/	positive
发现问题	neutral
个对焦框太大了风景摄影表现一般	negative
话说小白兔做的像一样	neutral
外观变丑了连续自动对焦的速度是最差的	negative
而是软件控制收缩	neutral
主要是因为色散控制不好的原因对焦点不行啊	negative
感觉在变焦的时候有些迟滞机械快门线的确蛋疼	negative
前段时间我刚在上入了港行	neutral
的屏幕不升反降	positive
取景器切换时候会有遮挡	negative
中央五个对焦点很暴力外观既没有时尚	positive
色彩不偏差稳定性照电子快门线和遥控器差的多	negative
无摄像功能电池使用寿命短不过该机器已经设计了外接电源的线孔	positive
上一幅画面尚留在取景器中	neutral
发现对焦速度有所降低玩了半年就出掉了主要是边缘成像太差色散严重	negative
他的操控让你能体验专业二字	positive
观景窗視野非常明亮	positive
机器内闪只有价格相对昂贵	negative
现在的按键用起来不爽光学取景器聊胜于无	positive
对不满意的地方	neutral
但在自动对焦操控感受上还存在一定差距风景摄影表现一般	negative
但镜头的压手感有利于持机稳定性	positive
已经有中阶级水准	neutral
一定要带上腕带	neutral
辅助对焦灯对于像这样的大镜头	neutral
稍逊于单反的机械性能感觉在变焦的时候有些迟滞	positive
似乎码率不够	negative
对焦慢	negative
我发现用连拍的时候	neutral
塑料前脸仍然没有升级成合金材料	negative
档有问题完全没有发挥半透镜优势的对焦张/秒的连拍速度	positive
的按钮不像那种磨砂的	neutral
开机慢大概秒以上就只是怪的色彩	positive
机身轻小后的缺陷装个都觉得头重脚轻套头成像颜色偏冷	negative
机背液晶屏竟然是塑料的/的快门大家都非常郁闷	positive
真的就是系统慢了点对焦点的选择也略蛋疼	negative
就是不太方便对焦速度还稍微跟不上	negative
用了半年了	neutral
很多人觉得造型很怪异密封不好等	negative
个人爱用之入门机款也将近快一年	neutral
这次买	neutral
奥巴的机器握感都不好感觉看不出噪点	positive
唉早知道就买了	neutral
那可差多了	neutral
锋利的成像	positive
但是长焦是外变焦机背液晶屏竟然是塑料的	negative
得益于图像处理器的配合	neutral
还配备各种机内滤镜	neutral
还频繁回看	neutral
在时也有较好的表现	positive
手感操控性能画质已然全面落后机身塑料感强轻	negative
镜头突出很多顺便吐槽这几个新出的镜头	positive
说实话	neutral
的焦段折算之后是比较适合在屋内拍摄	neutral
简单后期照片导出时还是很慢对焦速度一般	positive
因此背景的虚化不足对对焦点的明暗反差要求比较高	positive
顺便吐槽这几个新出的镜头长焦端光圈显得小了些	positive
我个人觉得这个功能大大提高了的可玩性	neutral
屏幕太破了虽说不太认同感动家的机身设计	negative
用好了有惊喜	neutral
给在和之间犹豫的人的建议如果你对图片清晰要求很高	positive
但是面对它的画质还有全幅视角	positive
但是阳光下的远景分辨率说句不好听的就像手机拍的一样而且紫边也不小对于有人说它是塑料机身	positive
但是一般的拍拍看看	neutral
机身建议考虑	neutral
不喜欢闪光灯的设计对焦点不行啊	negative
有人说要三四十秒	neutral
先说机身	neutral
但色彩略差于底部材料没有改进	positive
兼谈使用感受	neutral
此时用小一些的光圈	neutral
变焦感觉有点慢哦价格也最高	negative
接图的效果也不如的机身依旧采用工程塑料	negative
简单后期照片导出时还是很慢看着取景器里的对焦点从模糊清晰模糊清晰的过程的确有砸机冲动	negative
的工业设计真是倒退了三十年自动对焦较慢	positive
顺便吐槽这几个新出的镜头缺点是体积略大	positive
的电子技术确实不高不深	negative
头太贵了	neutral
缺点	neutral
我买了第一个副厂镜头腾龙的	neutral
带来的问题就是握持感屏幕太破了	positive
而到多张时才卡壳	neutral
取景器切换时候会有遮挡不满的是反映速度	positive
自动白平衡在某些特定场合容易出錯	negative
对焦真的没什么优势	negative
没有多次曝光功能镜头方面也有不足的地方	negative
一两秒后才会咔嚓虽然这中间还会追焦也能对上焦	neutral
好处自然是更直观	neutral
机身上有插孔	neutral
买来之后	neutral
我认为	neutral
缺点是体积略大感受在对焦的时候有些犹豫	positive
档案算蛮小的但在基本的锐利度表现	positive
另外新在拍人像的时候我基本都会向右曝光	neutral
以前很多人都说的机身差没什么用处	positive
液晶屏像素太低外观既没有时尚	negative
今天反差大	neutral
其他地方基本都满意	neutral
机器分为银色和黑色两款	neutral
对于有人说它是塑料机身最烦人的是不能全时手动	negative
就是对焦点多了而已	neutral
可能>>	neutral
做工一般重量重不少	negative
所以让人感觉塑料感稍重	negative
防抖没有想像中管用没有闪光灯	positive
感觉的比稍好	positive
差点儿让我崩溃	neutral
基本没用	negative
说明书木有	neutral
成像区别不仅取决于机身	neutral
边缘对焦还是比较容易拉风箱	negative
画面颗粒感较强表现在取景器和想比	negative
有一点要提一下	neutral
模式转盘	neutral
俺先后拥有过的　３００３５０３０．	neutral
于是昨天今天乘着早上上班和中午时间试了些片子	neutral
档案算蛮小的和的高感成像质量相比较而言就有些惨了	negative
摸上去也有点单薄	neutral
而且现在慢慢的带的机子也多了	neutral
操控分我给分	neutral
对焦的速度上并不是很突出操控缩水	negative
刚上市几天我就买了一台	neutral
和的高感成像质量相比较而言就有些惨了只有一个外置接口	negative
对焦点选择不是很方便操控缩水	negative
东西至少耐看	neutral
个人觉得直出非常锐	neutral
价格在２７元小于５０．	neutral
不如做工好快门延时稍长	positive
拍到再说	neutral
速度奇慢没有机内除尘是个问题	negative
所以在上面实际焦段是觉得不够广的朋友可以考虑副厂镜头的图丽的或者	neutral
顺丰快递还给力	neutral
还是个例外	neutral
自动白平衡在某些特定场合容易出錯录像按钮	negative
但那对焦速度我是受够了肤色偏黄	positive
高感只能在以下	neutral
的对焦屏密密麻麻全是点	neutral
比如白平衡没有显示自动白平衡在某些特定场合容易出錯	negative
比偏红偏假的色彩晚上拍照比较吃力	positive
现在的屏幕裸露在外机身轻小后的缺陷装个都觉得头重脚轻	negative
我觉得肯定不算好看	neutral
何況原厂拿做为搭配	neutral
就是格式照片有点偏大本人用寸笔记本它相机里电池自行放电由来已久	negative
但比松下还是差了很远	neutral
对于画质要求较苛刻并且以看原图为主的摄友	positive
新一代暗处色彩丢失可能是因为噪音太大导致严重降噪抹除了颜色	negative
感觉手柄还是略小机身轻小后的缺陷装个都觉得头重脚轻	negative
违背这种理解的就会被认作是异类	neutral
算是有的风格吧	neutral
现在这个样子怎么看怎么像镜头长倒过来似的对焦框不会显示	positive
不能选	neutral
我们还是要投一票	neutral
手动对焦更慢一些电池不够用	positive
享受一下高度便携性的乐趣吧	positive
高速卡帮助不大而且使用速度狂慢我用的是苹果一体机	negative
防尘不好快门声在体验时最想让我吐槽的就是它的快门声了	negative
你只有一秒钟的机会	neutral
只有人类会因为没有而不高兴的	neutral
而且使用速度狂慢我用的是苹果一体机但那对焦速度我是受够了	positive
的我一会不敢超过肩屏显示的信息很多	positive
但是在光线一般的情况下有的几率拉风箱	neutral
用的时候屏幕并不会停止工作	neutral
可人家是手机	neutral
视野广	positive
做工不错	positive
长焦端成相可接受	positive
对焦点有点集中快门声音比我想象的大得多	negative
什么时候和将要发布的	neutral
密封不好等感觉在变焦的时候有些迟滞	negative
这次试用也不例外	neutral
附带的解软件解出来的效果非常差对焦的确非常非常慢	negative
总的来说用来拍人像肤色怪怪的做工一般	positive
这个头么	neutral
现在手头还在的是	neutral
除了没有触摸屏以外	negative
对焦太慢了不满的是反映速度	negative
而转盘开机波轮和闪光灯貌似都是整块的金属	neutral
但是由于平时比较忙	neutral
机身港币=	neutral
因为抓拍的时候没有时间去设定曝光	neutral
对我来说除了对焦其他全部满意	neutral
给你的更大的创作空间	neutral
花钱费力不说	neutral
但是阳光下的远景分辨率说句不好听的就像手机拍的一样而且紫边也不小	negative
所以应该使用曝光锁定或手动设置	neutral
除了框框	neutral
红色的很明显	neutral
转盘和那个十字大按键有些容易误操作功能不如	negative
很多人觉得造型很怪异如果能忍受它缓慢的存储速度的话	positive
的我一会不敢超过	negative
可以一键恢复中央对焦	neutral
刚上手觉得操作特别困难但在基本的锐利度表现	positive
对焦精度太差了的对比对焦显然没有的相位对焦快	positive
还有品控问题反光板污点门而且定价太高了	negative
用过/系统的人绝对会受不了的触摸屏没有内闪	negative
我只能说要拍视频就自己手动对焦吧	neutral
底部材料没有改进没有任何提示和显示	negative
因为经常看到有人说的声音一塌糊涂但是屏幕实在不堪入目	negative
说完白平衡后	neutral
对焦点不行啊高感不好	positive
俺从过来的	neutral
对焦框不会显示屏幕太破了	positive
像素提升了万	positive
锐度高	positive
但因为绿屏问题实在让我觉得膈应拍出人物的皮肤较硬	positive
一种机器	neutral
都快赶上单反的价格了	neutral
对焦用自动	neutral
很多人觉得造型很怪异机身塑料感十足	positive
在防抖方面	neutral
对焦点的选择也略蛋疼但在大光圈长焦和闪光灯上还有不足	positive
真的就是系统慢了点	negative
大网站测评据说对焦是超越的	positive
没有机内除尘是个问题人脸识别识别率木有手机或者强	positive
没有功能手感操控性能画质已然全面落后	negative
但是屏幕实在不堪入目机子太小太轻	positive
小黑虽然部分焦段锐度跟不上对焦点不行啊	negative
但那对焦速度我是受够了但在基本的锐利度表现	negative
这个和对焦方式及镜头的重量都有关系	neutral
我从星光店里的营业员那里解到	neutral
快门打到尽然有重影镜头突出很多	negative
高感不好手感操控性能画质已然全面落后	negative
特别在莲花罩反插的时候镜头像大了一个圈似了	neutral
对我来说足够了用了	neutral
像素提升三倍后裁剪空间大了许多	positive
色彩感觉没有原来的容易调整顺便吐槽这几个新出的镜头	negative
出图也没此刻的干净	positive
这个我很看重	neutral
用过/系统的人绝对会受不了的触摸屏个对焦框太大了	negative
做工一般	negative
欢迎台机器都用过的发表评论	neutral
清晰锐利	positive
我买的时候也只有万的预算	neutral
还和镜头有些关系	neutral
最烦人的是不能全时手动	negative
求推荐	neutral
对焦速度偏慢虽然在强度上有些降低	negative
夜景画质很一般手柄突出部分和镜头对焦环之间的空间挤了点	negative
整体机身变得更加圆滑	positive
只有一个外置接口	negative
试拍几张	neutral
毕竟从到今天的的确为价格和成本简化了很多东西	neutral
较大的相机体积	positive
优秀的手感	positive
的选择已经有了	neutral
没见到有和	neutral
洞妖的明显要慢于的但是长焦是外变焦	negative
存取慢它的功能上的确有些不足	positive
以前觉得取景器不可替代	neutral
但是长焦是外变焦对焦速度慢这个完全不能和单反比啊	negative
想搞点创意拍摄很考较后期功力	neutral
可能握持上不是太舒服其实松下除了画质外	positive
人脸识别识别率木有手机或者强所以设计理念上不高明	negative
不过而且毕竟单反发展了几十年	neutral
欢迎补充	neutral
也太贵	neutral
辅助对焦灯跟上一样	neutral
总体比较喜欢	neutral
色彩不正及过渡不好电池续航能力一般	negative
塑料前脸仍然没有升级成合金材料肤色偏金黄色	positive
主要原因是手不稳	neutral
我没发现跑焦难道是我眼神不好	neutral
左侧的接口布局有了改变	negative
受苹果影响	neutral
觉得有用的参考下	neutral
而且那个时候的价格还比较高	neutral
谁知道会咋样呢	neutral
四没有防抖但是外挂电源毕竟影会影响的便携性	negative
新一代暗处色彩丢失可能是因为噪音太大导致严重降噪抹除了颜色光学取景器聊胜于无	negative
外观既没有时尚当然这也许是白平衡的问题	positive
换以上像素	neutral
写速度实测只有左右	neutral
有除尘功能	positive
现在保留了经典的白色	neutral
最近去了次德国	neutral
不过对大光比的控制方面明显不如全副像素密度太密了	negative
取景窗的取景框还是倍	neutral
相信不会令我失望吧	neutral
对焦优异	positive
对焦速度还稍微跟不上肤色偏金黄色	negative
的工业设计真是倒退了三十年但我却很喜欢真实的色彩	positive
打算升级选择其中一款	neutral
一个系统居然同时使用个不同的闪光灯接口	neutral
存储速度慢的对焦	positive
而远角端只有	negative
变焦感觉有点慢哦二是体型偏大了	positive
到到现在的	neutral
快门延时稍长没有确实有点影响出片率	negative
后来我们家小宝宝出生了	neutral
不过手感一般稳定性照电子快门线和遥控器差的多	negative
接图的效果也不如这只镜头配合起来就有点问题	positive
觉得电池续航能力很一般窃以为还是的软件功底差了	positive
其余的对焦点闪光灯没有闪光灯	positive
不过感觉快门很涩转盘和那个十字大按键有些容易误操作	positive
正好元旦到手	neutral
但是对焦真的很好	positive
片子发暗种种现象对焦点的选择也略蛋疼	positive
色彩的话其次是那个主拨盘	negative
省下的重量让我能够携带别的器材	neutral
辅助对焦点可以显示拍摄物是否在对焦距离内	neutral
还是很快的	neutral
特别是电池舱盖广角端边缘锐度不行	negative
电池电池的改变不小	neutral
图象完全看不清楚为什么照片这么小	positive
明显敌不过底部材料没有改进	negative
的感光度在的时候也只能说勉强凑合看炒冷饭	negative
稍后上机器照片	neutral
比的要好	neutral
稳定性照电子快门线和遥控器差的多	negative
不满的是反映速度	negative
直出太差了我最不满意的是那个删除键	negative
其实道理很简单	neutral
切机身严防磕碰	negative
她有时也似模似样对着孩子一通乱点	neutral
底感差只有一个外置接口	negative
用和的电池很难吗	neutral
没其他机器了	neutral
网上好多朋友都说干掉了	neutral
完全没有发挥半透镜优势的对焦张/秒的连拍速度但我没有在包装里面找到高清视频线	negative
个对焦框太大了录像按钮	positive
画面也惨不忍睹洞妖的明显要慢于的	positive
不过考虑到做的那么小	neutral
	neutral
把放到脚架环那一节去	neutral
画质高感低感全部都将杀得爹妈都不认识了	positive
感觉开关拧到距离过长这景深伤不起	positive
感谢叹息老师等各位朋友的中肯建议	neutral
目前看好的高感	positive
不过手感一般感觉开关拧到距离过长	negative
电池不够用切机身严防磕碰	negative
简陋了很多	neutral
试用感受	neutral
说明由于机身上不可能把上百个镜头数据都装在里面	neutral
以前的用过两台	neutral
光圈环在镜头上	neutral
就是紫边太严重没有任何提示和显示	positive
通过试拍我发现	neutral
前一段有了小宝宝	neutral
薄了	neutral
图像很硬操控缩水	negative
主要是最小光圈只到也没专业	negative
而是细节上的精细感受	neutral
以后慢慢试	neutral
本人也有	neutral
机身缝隙稍大机内测光容易出错导致过曝	positive
都没问题	neutral
跟着说明书直接拍了张的照片	neutral
套头性价比高	positive
对焦速度还稍微跟不上致命的阳光下看不清屏幕	positive
全高清视频拍摄功能等众多亮点再加上元区较高的性价比	positive
质量还不如以前的光线暗的时候对焦拉风箱	positive
带给我的则是惊喜	neutral
而照相优化过的三星品牌系统手持设备	positive
配长焦机身偏小机身塑料感强轻	positive
数据线都不配目前价位还是高于的	positive
由于采用了轻质的金属机身外壳	neutral
值得入手	neutral
可是定焦也太小气了没有	negative
也可以用引闪器离机引闪	neutral
提高了握持手感和防滑性能	positive
原来的没发现有什么问题	neutral
类似导弹锁定操作	neutral
而是平稳过渡	neutral
有些人会说这些都是给新手用的但是真的挺方便的特别是对于懒人来说拍大光比的风景很有用	neutral
那中间的呆滞时间大概要秒左右	neutral
镜头是电调变焦	neutral
对焦点不再使用蚀刻	neutral
机身没太大区别	neutral
这一点肯定要优于入门相机	neutral
哇那个惊艳	neutral
这个是卡片机的强项	neutral
就是这样一台集便捷的操控	positive
那卖给谁	neutral
高感也不比/差	positive
有同事拿了一台	neutral
操作系统反映速度很慢比如白平衡没有显示	negative
随便用	neutral
表现的就非常完美	neutral
我始终认为相机是需要有一定体积和重量的	neutral
快门打到尽然有重影对焦叽叽的叫声让你觉得随时要坏	negative
就是对焦前先来回抽一下让人蛋疼连续自动对焦的速度是最差的	negative
使你用无法拍摄或者说不好意思拍摄的窘境消失	neutral
防抖没有想像中管用	negative
所以	neutral
单个镜头跑焦记录功能	neutral
目前价位还是高于的对焦太慢了	positive
都是同档次相机中顶尖甚至是超越其他品牌顶级机身的	neutral
想问问为什么的照片这么小啊但是强劲的机能会弥补画质的不足	negative
如果喜欢奥巴可以考虑	neutral
让那些用的女士双臂平伸端着手感很差的克重物显得那么滑稽可笑对焦的确非常非常慢	negative
也没有用好	neutral
//太多次把自动合焦点放到鼻子上是不是和我的操作不当有关	neutral
完全没有发挥半透镜优势的对焦张/秒的连拍速度外观变丑了	negative
对焦速度还稍微跟不上就是的色散比重引起的	negative
慢慢编辑	neutral
导入照片自动识别	neutral
与三星的一些感受或者说无图测评	neutral
不过不允许插卡	neutral
对焦点的选择也略蛋疼价格也最高	negative
截止到年月日	neutral
实际用下来也是如此	neutral
首先是那个和啤酒瓶子盖一样的模式转盘就是的色散比重引起的	negative
价格	neutral
需要说明的是	neutral
带来的问题就是握持感也不好逃出紫边	negative
实际使用的时候调整对焦点很方便	positive
锁定购入机种主要在与最近刚推出的新款产品相当火热的	neutral
明显敌不过说明他的电子设计和技术较低端	negative
锐利且鲜艳	neutral
外盖分成了三部分闪光灯就算了	negative
但便携机在图像质量上总是稍欠缺一点还有不能换镜头局限了拍摄题材而腾龙出片我个人感觉比较像一个数码记录图像	negative
洞妖的对焦速度大致相当于/的水平	neutral
看来	neutral
但其实	neutral
厂家不在乎这一点成本吧	neutral
在机身细节部位要比二代用心很多	positive
因为并没有停产	neutral
的机身实拍图	neutral
就是对焦前先来回抽一下让人蛋疼但实际试用发现对焦迟滞太严重	negative
等你拿到机子后	neutral
表现在波轮的阻尼按钮布局以及显示屏质量等细节方面	positive
和开头的机器甚至开头的机器都不相符的塑料卡口闪光灯没有闪光灯	negative
塑料感强	negative
也有紫边对焦的确非常非常慢	negative
便会毫不犹豫的捕捉上	neutral
所以用的是的镜头	neutral
会继续大力发展系列了另外体积比小也算是的优势吧	positive
的非常差二是体型偏大了	positive
正面右下角多了一个大大的	neutral
就只是怪的色彩不如做工好	positive
照远景效果比许多机子差图像很硬	negative
左侧的接口布局有了改变拍的好像蒙了一层雾	positive
也是迅速无比	neutral
没有测连拍	neutral
录像按钮对焦精度太差了	negative
但是阳光下的远景分辨率说句不好听的就像手机拍的一样而且紫边也不小不如做工好	positive
正面太滑炒冷饭	negative
对这两款机子的定位非常明晰	neutral
档的超级功能木有了体积太大	negative
肤色偏金黄色景深预览键没有	negative
左上角的拨盘看上去仍然很幼稚价格对我来说也贵了	negative
可以少退几米拍全身	neutral
拨盘和拨轮的结合让误操作将为了最低	neutral
但是屏幕实在不堪入目没有功能	positive
所以让人感觉塑料感稍重色彩不偏差	negative
一场下来	neutral
的手感给我一种新的感受	positive
说明他的电子设计和技术较低端艺术效果拍摄时拖尾严重	negative
手上恰好有和	neutral
感觉手柄还是略小结果对焦和色彩让人失望	positive
入手一周	neutral
它的做工确实精湛镜头也很漂亮就是一件工艺品	positive
拍出人物的皮肤较硬因此背景的虚化不足	negative
没有内闪自动对焦较慢	positive
这令我有些不爽	neutral
灯光下不准	neutral
有门道	neutral
光学取景器聊胜于无	negative
所以根本没有机震	positive
外观变丑了但是长焦是外变焦	negative
这么密的小像素除了价格比较高一些	positive
这是镜头太水的原因导致无法进行连续拍摄	positive
考虑到美元的定价	neutral
拍什么类型的比较多这样有针对性的购买镜头是比较理想的	neutral
无它	neutral
机身蒙皮有没有改进	neutral
增加了万像素	positive
屏幕太破了格式连拍坑爹	positive
不喜欢闪光灯的设计亮度还是偏低	positive
大家好	neutral
在整体感上还更胜一筹	positive
出来的片子更糟液晶屏像素太低	positive
下周末要去真的了	neutral
现在比较纠结买还是不买	neutral
特别是表面喷漆工艺不再向以前那样让人担心	neutral
连相对完美的你都找不到一款	neutral
怎说呢	neutral
因为使用了万像素感光原件	neutral
只有从机顶看觉得造型怪异些不如做工好	negative
个人认为略微欠缺	neutral
试拍结果表明	neutral
就别提前两代产品了	neutral
因为我用的第一款带除尘功能的数码单反是	neutral
也为设计了全新的卡口	neutral
确实贵得有道理	neutral
价格相对昂贵的对比对焦显然没有的相位对焦快	positive
年的月份	neutral
我选择的只是好用耐用的器材	neutral
利于不干扰对象	neutral
对得起这个价格	neutral
月陪朋友去买时看到了的就叫老板拿来玩一下	neutral
连拍的威力真的很爽	positive
只是固定在架子上	neutral
操控优秀的个机子	positive
呵呵．	neutral
长焦端没有防震自动白平衡在某些特定场合容易出錯	positive
没有对焦点不行啊	positive
开始心里还有些打鼓	neutral
不爽的暂时没有	neutral
月份的机器	neutral
对于有人说它是塑料机身因为之前的的画质堪称垃圾	positive
洞妖宾得是艺术品	neutral
高速卡帮助不大塑料感强	negative
背面的变化相对于来说有不小的变化	neutral
操控缩水价钱不算低	positive
操作系统反映速度很慢还有就是确实存在严重的屏偏绿的问题	positive
窃以为还是的软件功底差了现在的屏幕裸露在外	positive
自动对焦较慢	negative
毕竟不是原厂	neutral
要求用它拍	neutral
如果是随拍	neutral
在肩屏的信息显示量上也不够丰富快门声音真心不好听	negative
不太现实	neutral
的遮光罩为什么总是做的很松我最不满意的是那个删除键	negative
这时=元了	neutral
广角端边缘锐度不行但我没有在包装里面找到高清视频线	negative
原来单位的小痰盂晚上在家拍娃	neutral
关注了很久小数码	neutral
景深较浅	neutral
确远在之上洞妖跟小五犹如狙击枪和机关枪的差别	neutral
但便携机在图像质量上总是稍欠缺一点还有不能换镜头局限了拍摄题材存取慢	positive
没有功能而且很象没有录像	negative
的连拍和出色的机震控制也给我留下了很深刻的印象	positive
机内测光容易出错导致过曝总的来说用来拍人像肤色怪怪的	negative
就是格式照片有点偏大本人用寸笔记本	negative
看多久	neutral
小黑虽然部分焦段锐度跟不上闪光灯就算了	positive
我的就是最小的暗部噪点也清晰可见操作的时候小里小气的	positive
对焦速度一般	negative
镜头后组距离感光元件极近	neutral
新机仍然没有解决这个问题	neutral
手动对焦更慢一些明显敌不过	positive
和的比似乎就少了点相位对焦点就说下设计上的不足	negative
高感不好我的就是最小的暗部噪点也清晰可见	negative
第三天又恢复正常	neutral
在三八妇女节来临之际	neutral
主力还是在单反	neutral
感觉不是太好	neutral
对焦速度慢	negative
边缘对焦还是比较容易拉风箱但是长焦是外变焦	positive
莲花罩和转接环都是旋转卡位设计	neutral
手动对焦有	negative
我用几年前的卡	neutral
不过感觉快门很涩首先是那个和啤酒瓶子盖一样的模式转盘	negative
对焦速度和精度明显提高不再犹豫	positive
入这个头真是毫不纠结的	neutral
我给它便携性打分	positive
感觉在变焦的时候有些迟滞但便携机在图像质量上总是稍欠缺一点还有不能换镜头局限了拍摄题材	negative
洞妖的明显要慢于的不过与相比的机身确实短了一些从左到右方向	positive
有跑焦	neutral
元入手	neutral
六的手动对焦环是假的是对焦环不是变焦环它的手动变焦环很爽就一姐夫机的大小	positive
另外	neutral
不喜欢闪光灯的设计暂时还不够丰富的系统	positive
前天一个小姑娘来卖	neutral
有时在长焦段会有拉风箱现象对焦点选择不是很方便	positive
基本没用因为之前的的画质堪称垃圾	negative
最终入手	neutral
机身的操控性能很好	positive
但在基本的锐利度表现的工业设计真是倒退了三十年	negative
特别是我们拍新闻照片	neutral
而对焦准度	positive
不过如果用手持	neutral
拍摄活动物体和体育运动能力弱	neutral
开机慢大概秒以上系列的画质一般	positive
为了避免换系统的情况	neutral
根据俺的猜测	neutral
简单说下的感受	neutral
我是从来不敢使用以上的感光度去拍人像的我最不满意的是那个删除键	negative
对强光源的处理不好肤色偏金黄色	negative
拉风箱	neutral
几乎每组都出现了一张欠曝的样片	neutral
镜头突出很多同样快门速度	positive
新入的	neutral
在机身方面已有所改进	positive
对焦	neutral
但色彩略差于细节较多	positive
直接出片机内处理锐度过头了点片子发暗种种现象	negative
配了电子取景器	positive
有几张试用的感光度	neutral
不过与相比的机身确实短了一些从左到右方向	negative
照远景效果比许多机子差	negative
感觉像多了个不同的镜头	neutral
对焦行程做得那么长只是控制和手感恐怕没有这么舒服	positive
这个是微单的通性也不用多说了	neutral
结果对焦和色彩让人失望和的高感成像质量相比较而言就有些惨了	positive
心里不断安慰自己反正电视台拍电视也是手动对焦嘛	neutral
出来的肤色也是偏黄的	neutral
行程按一天来算的放	neutral
好处之二就是更高的分辨率	positive
的我一会不敢超过且目前售价也略高	negative
左上角的拨盘看上去仍然很幼稚	negative
只有的镜头比较平一点	positive
小黑虽然部分焦段锐度跟不上	negative
没有防水防尘在肩屏的信息显示量上也不够丰富	negative
夜景手持真的很吃力可是它的机械性能又实在是不好	positive
按键及速控转盘的手感也作了修正	neutral
手动功能是宾得的传统强项	neutral
暂时还不够丰富的系统重量重不少	positive
目前价位还是高于的功能不如	negative
对焦的确非常非常慢而且定价太高了	negative
尽管经常频繁地更换镜头	neutral
直接做到了里	neutral
也没专业似乎码率不够	negative
色彩不够鲜艳操作的时候小里小气的	negative
建立创意闪光系统	positive
总而言之是一部很好用的随身机子	neutral
新买使用感受心得以及试机片．	neutral
照片上很难看	neutral
啊	neutral
机身塑料感强轻图像很硬	negative
哪里需要按钮都首先要考虑使用上的需要	neutral
档的超级功能木有了机子太小太轻	negative
这样的防抖效果会好点	neutral
明显敌不过白平衡只能菜单调	positive
边缘对焦还是比较容易拉风箱但我宁可这样也不要糟糕的做工	negative
有些场合更换镜头是致命的	neutral
网购倍光变裸机金色	neutral
对焦行程做得那么长拍出来白蒙蒙的	positive
我是从来不敢使用以上的感光度去拍人像的让那些用的女士双臂平伸端着手感很差的克重物显得那么滑稽可笑	positive
有一个现象	neutral
手动对焦更慢一些主要是因为色散控制不好的原因	negative
但在基本的锐利度表现在肩屏的信息显示量上也不够丰富	negative
普通线插不进去了	neutral
正确方法是买一张大容量的低速卡	neutral
在室内弱光下两者则差不多	neutral
现在的屏幕裸露在外最大的问题是为小体积而小体积	negative
蒙皮基本上全翻起来了	neutral
不过总觉得应该改进一下降噪算法	neutral
别人还不会注意你	neutral
总得来说还算值这个价	neutral
感觉对焦速度很快	positive
就感觉出来的片子更糟对强光源的处理不好	positive
重量重不少长焦端光圈显得小了些	negative
如果能有对焦微调只不过应该会耗费不少电力吧	positive
固件升级后的机器可以设置自定义键	neutral
适当保护下	neutral
操作的时候小里小气的	negative
我觉得的机身手感很不理想明显敌不过	negative
对焦精度太差了接图的效果也不如	negative
其余的对焦点	negative
拍出来白蒙蒙的档有问题	negative
这只镜头配合起来就有点问题锐度偏低	negative
极大的方便了用户对各种功能的设置	neutral
成了真正的超广	neutral
导致无法进行连续拍摄以前很多人都说的机身差	negative
也是可以原谅的	neutral
但这比　和的和要好很多了	neutral
买的时候知道比机身小一圈	neutral
色彩的话机身塑料感十足	negative
在使用挂机	neutral
色彩灰暗对焦速度慢	positive
好多了	neutral
图像刷新率很高	positive
拍人像很难突出主题	neutral
欢迎和谐讨论	neutral
估计完全可用了	neutral
速度奇慢机内软件可能有问题	negative
真有把式	neutral
但客户就认	neutral
也改变了我一贯抱有的对感光度上限的使用习惯	neutral
高速卡帮助不大同样快门速度	negative
的高表现是值得依赖的	positive
或者长按快门键进入拍摄界面	neutral
只是开电池舱盖和卡舱盖的时候能明显感觉到塑料的做工外观既没有时尚	negative
只有在去动物园的时候用过一次	neutral
主要是最小光圈只到当然这也许是白平衡的问题	positive
同时给配了和	neutral
就是色彩比较淡档的超级功能木有了	negative
一旦按下快门	neutral
还不错	neutral
左侧的接口布局有了改变的对焦	negative
对焦速度一般拍出人物的皮肤较硬	negative
我自己用的和也用过别人的	neutral
用户有	neutral
表示很欢乐	neutral
各取所长	neutral
整体操作非常方便	positive
整体感觉就是一入门机的样子照远景效果比许多机子差	negative
做为一个相机	neutral
照片是自动翻转过来的	neutral
还说要吃个月的萝卜咸菜了	neutral
但是打开机以后	neutral
发这个帖子也并不是顶	neutral
肩屏显示的信息很多但是阳光下的远景分辨率说句不好听的就像手机拍的一样而且紫边也不小	negative
镜头方面也有不足的地方液晶屏像素太低	negative
如果外出旅游应该是个不错的选择	neutral
肩屏小了些左上角的拨盘看上去仍然很幼稚	negative
成功率不低	neutral
感觉开关拧到距离过长机身蒙皮磨蚀严重	negative
画面也惨不忍睹对焦行程做得那么长	positive
底感差对强光源的处理不好	negative
闪光灯没有闪光灯机内测光容易出错导致过曝	negative
炒冷饭	negative
五操作便捷性和手感	neutral
结果对焦和色彩让人失望	negative
我只是一个理性购买器材的摄影爱好者	neutral
右手大姆指按快门的拍摄方法	neutral
未发现跑焦现象	neutral
一句话堵死我微单拍的没单反好	neutral
也没专业但是长焦是外变焦	negative
按键按起来啪啪响小五就成打酱油的	negative
没有功能机身塑料感十足	positive
一是太小完全不像是消费专业级数码相机的水平对焦速度是目前单电系统软肋	positive
二是体型偏大了外盖分成了三部分	negative
逛蜂鸟发现一合作商户特价	neutral
对于有人说它是塑料机身因为之前的的画质堪称垃圾	positive
还有	neutral
风景摄影表现一般	negative
另外高感也差很多体积小	negative
简单后期照片导出时还是很慢还有就是确实存在严重的屏偏绿的问题	negative
但是便携性较差的对焦	positive
比偏红偏假的色彩用过/系统的人绝对会受不了的触摸屏	positive
感觉机身的自动白平衡有点问题键位设置不如全副方便	positive
只是开电池舱盖和卡舱盖的时候能明显感觉到塑料的做工就是格式照片有点偏大本人用寸笔记本	positive
说看起来一样的可以换个显示器了	neutral
连续自动对焦的速度是最差的高感有说不如的	positive
正面太滑感觉看不出噪点	positive
但是外挂电源毕竟影会影响的便携性软件不太好使	negative
在低感情况下	neutral
用完还给了朋友	neutral
对焦感觉都差不多	neutral
操作上更方便了	positive
另外金属机身应该是吧和３寸的屏幕也是我比较中意的地方．	positive
绝对是一把好手	neutral
基本没用就是格式照片有点偏大本人用寸笔记本	negative
手柄突出部分和镜头对焦环之间的空间挤了点电池不够用	positive
电池太渣因为之前的的画质堪称垃圾	negative
不过最好上架子拍静物	neutral
所以精确度很高	positive
我是用户断然选择了小黑	neutral
首先是那个和啤酒瓶子盖一样的模式转盘感觉看不出噪点	positive
带来的问题就是握持感主要是高清视频录制清晰度差	negative
将来必入	neutral
但在实际使用中	neutral
快门打到尽然有重影顺便吐槽这几个新出的镜头	positive
来回摆弄几下就挺明白了	neutral
万像素	neutral
特别有一点就是	neutral
这头的色彩	neutral
但是太沉了	neutral
就是的色散比重引起的但是感觉跟还是有一定差距的	negative
这种菜单方式与的类似	positive
手感操控性能画质已然全面落后镜头突出很多	positive
但是长焦是外变焦体积太大	positive
当然的优势在于对得更准	positive
作为用户	neutral
更鲜艳	neutral
基本不会去关心这个问题了	neutral
对焦比快	positive
对焦速度和精度明显提高不再犹豫	positive
寸万象素的液晶屏有点落伍了有时在长焦段会有拉风箱现象	positive
今天用了	neutral
比起前不久玩的朋友的	neutral
可以显示出电池的剩余量	neutral
如果没有进	neutral
通过我一年半的使用	neutral
更准确的表达	neutral
不闪光的情况下	neutral
也用自己的卡插到其他样机试拍并带回了试拍片子	neutral
所谓速度不快那是对比	neutral
出来的片子更糟这么密的小像素	negative
可不能错失瞬间的精彩	neutral
很多人诟病	neutral
由于这朋友借我的镜头是腾龙的	neutral
但是外挂电源毕竟影会影响的便携性寸万象素的液晶屏有点落伍了	negative
一直嫌那两台单反有点笨重	neutral
主要是因为色散控制不好的原因价格也最高	positive
松下出来的图片的比对度的确有点不够高感有说不如的	positive
边缘对焦还是比较容易拉风箱体积小	positive
上周带着洞妖去爬山的	neutral
关于对焦	neutral
我都很无语;	neutral
对焦快	positive
作为一款平民化的全幅	neutral
机身轻小后的缺陷装个都觉得头重脚轻	negative
用拍的片子和用甚至拍的片子相比	neutral
也基本不出现抖动引起模糊的情况	neutral
左上角的拨盘看上去仍然很幼稚感觉在变焦的时候有些迟滞	positive
有点薄	neutral
有些拍摄感受	neutral
价格对我来说也贵了速度奇慢	negative
拿在手里看	neutral
还是比较让我满意的	neutral
但是像素比较低现在觉得我完全不需要高像素这点下面我会解释价格对我来说也贵了	negative
手感操控性能画质已然全面落后机身塑料感强轻	positive
不过同时发现另外一个问题	neutral
但边沿能对上的逆光低反差场合	neutral
切换到手动对焦模式	neutral
广角端边缘锐度不行压缩比有些点	negative
算得上一部很耐玩的相机	neutral
机身则是	neutral
拍了一张全黑图	neutral
还有品控问题反光板污点门的遮光罩为什么总是做的很松	positive
发现对焦速度有所降低	negative
的遮光罩为什么总是做的很松感觉在变焦的时候有些迟滞	positive
有高清录像老婆更喜欢高像素喜新厌旧	positive
出片	positive
相比较原系列锐度高了不少这一点好与不好大家有争议	positive
对焦速度:	neutral
现在看那些片子	neutral
比如白平衡没有显示	negative
有时候界面操作都会有些许延时现象有时候界面操作都会有些许延时现象	negative
改成之后虽然画质变好	positive
有手柄据更好了	neutral
特别是夜晚	neutral
缺点不少	neutral
但愿今后的固件能改进这项功能	neutral
有时候界面操作都会有些许延时现象但是便携性较差	negative
体积小机内软件可能有问题	negative
没有确实有点影响出片率	negative
但是根据我个人观察	neutral
拍的好像蒙了一层雾除了没有触摸屏以外	negative
只是属于最严重的一类反差较小时镜头还会拉风箱	negative
用了不爽	neutral
键的使用	neutral
这个我就不说了	neutral
但对色彩的处理还不如众老厂经验丰富用转接要好很多但又没有了自动对焦	negative
不过色彩还是比我之前用的松下好不少的	positive
无论你安装上什么镜头	neutral
不知不觉入手个月了	neutral
做工非常精细	positive
给力哈哈	neutral
没有内闪比如白平衡没有显示	negative
带来的问题就是握持感的对焦屏比较简单的感觉	negative
数据线都不配几个小按钮的感觉也是如此	negative
对我而言	neutral
转盘和那个十字大按键有些容易误操作晚上拍照比较吃力	negative
对焦速度慢它相机里电池自行放电由来已久	positive
便把卖了	neutral
就是色彩比较淡塑料前脸仍然没有升级成合金材料	positive
大致都要秒左右的时间	neutral
高感不好没有防水防尘	negative
都是非常值得入手的	neutral
现阶段价格感觉还是可以再低一些	neutral
闪光灯就算了反差较小时镜头还会拉风箱	positive
最近没什么好天气	neutral
视频画面很棒并且还可以裁切	positive
把调高了	neutral
那个时候大概是年之前把	neutral
出头性价比无敌	positive
试用了一段时间	neutral
对焦速度慢这个完全不能和单反比啊的电子技术确实不高不深	negative
也希望出和的时候	neutral
只不过应该会耗费不少电力吧稍逊于单反的机械性能	negative
但是搞不清最小快门是怎么控制的	neutral
但是感觉跟还是有一定差距的只是属于最严重的一类	negative
使用感受与常规性能对比纯个人感受	neutral
再入真一处理器的	neutral
系列的画质一般直接出片机内处理锐度过头了点	positive
从操控感上	neutral
我手持拍摄的出片率较低用转接要好很多但又没有了自动对焦	positive
中心点的双十字不是浪得虚名	neutral
锐度偏低底部材料没有改进	negative
对于手动头是个福音	positive
给取景构图带来了局限	neutral
如果能忍受它缓慢的存储速度的话	negative
快门延时稍长但在自动对焦操控感受上还存在一定差距	negative
毫无画质可言	neutral
边缘对焦还是比较容易拉风箱功能不如	negative
操控缩水便宜好用的自动镜头少	positive
和转换差别不大	neutral
组合挂在本人脖子上并不使人感觉非常沉重	neutral
先对焦后构图速度太慢且容易焦点偏移就感觉出来的片子更糟	negative
但是长焦是外变焦塑料感强	negative
不到两个小时	neutral
可能握持上不是太舒服	negative
优点方面	neutral
综合来说更给我开机工作的欲望	neutral
说明他的电子设计和技术较低端录像按钮	positive
就是一台没有电话功能比如白平衡没有显示	positive
拍出来白蒙蒙的	negative
可是在电脑上看	neutral
的非常差	negative
色彩不偏差同样用测试对焦	positive
问题是体积也没见小啊先对焦后构图速度太慢且容易焦点偏移	positive
重量电池卡相机=克	neutral
对他们来说除了	neutral
当发布时让我眼睛一亮	neutral
如果不考虑其他的话其实也足够用了	neutral
这一点很不爽	neutral
对焦点选择不是很方便松下出来的图片的比对度的确有点不够	negative
要入我法眼的备机便携性是	neutral
会不会有很大的提升	neutral
的工业设计真是倒退了三十年新一代暗处色彩丢失可能是因为噪音太大导致严重降噪抹除了颜色	negative
真是好	neutral
不想用手柄	neutral
试过边缘对焦亮度还是偏低	negative
手柄造型也更贴手型	positive
但在大光圈长焦和闪光灯上还有不足对焦速度一般	negative
说结实	neutral
说明他的电子设计和技术较低端高感就不要太奢求了	positive
快门声在体验时最想让我吐槽的就是它的快门声了最大的问题是为小体积而小体积	negative
也还是见仁见智了	neutral
总之都比好	neutral
给了我一个均衡的理由	neutral
最好不是外挂的	neutral
胜档	neutral
难道是为转接服务	neutral
自己够用就好	neutral
比较习惯	neutral
的工业设计真是倒退了三十年这么密的小像素	positive
出门不带包或背带	neutral
手柄也太小但是外挂电源毕竟影会影响的便携性	negative
借鉴一下奥巴的对焦技术应该也有可能	neutral
人脸识别识别率木有手机或者强拍出来白蒙蒙的	positive
对焦速度	neutral
只是之前	neutral
但驱动有点慢	negative
罗罗嗦嗦说了那么多	neutral
现在这个样子怎么看怎么像镜头长倒过来似的用过/系统的人绝对会受不了的触摸屏	negative
以上都是个人感受	neutral
直接出片机内处理锐度过头了点对焦速度还稍微跟不上	negative
肩屏显示的信息很多机身手感一般	negative
但总体来说还是不错的	neutral
且目前售价也略高拍出来白蒙蒙的	positive
添加红色是为了在颜色浅的情况下更好的使用	neutral
接片等等	positive
就感觉出来的片子更糟导致无法进行连续拍摄	positive
没有什么风格上的大区别	neutral
本人被它的对焦速度折磨了一个半月后果断出掉	neutral
成功率低得多	neutral
可是定焦也太小气了充电感觉不是很方便	negative
没时间也没条件验证灰和光圈不准的问题	neutral
如果我自已花钱买机身的话	neutral
你话买么	neutral
摄影是一个创作的过程	neutral
以下纯是个人感受	neutral
二是体型偏大了我觉得的机身手感很不理想	negative
大概一年多了	neutral
防抖没有想像中管用这是镜头太水的原因	negative
不喜欢闪光灯的设计有时候界面操作都会有些许延时现象	positive
于是趁减价的时候出了入了	neutral
暗部对焦拉风箱	negative
我看了都心疼	neutral
当你需要拍下一个画面时	neutral
要是上了	neutral
表现在取景器和想比用过/系统的人绝对会受不了的触摸屏	negative
加上机器本身很贵	neutral
导致无法进行连续拍摄	negative
出门还是不方便	neutral
手感操控性能画质已然全面落后拍出来白蒙蒙的	positive
对焦点选择不是很方便对焦太慢了	negative
我现在仍然是一块电池而已	neutral
一些实拍	neutral
没有防水防尘	negative
携带	neutral
外观既没有时尚自动白平衡在某些特定场合容易出錯	positive
除了价格比较高一些个对焦框太大了	negative
为些专门设计了键	positive
而可能需要不到半秒种就能对上	neutral
五很多种拍运动追焦的选择	neutral
因为之前的的画质堪称垃圾对焦速度一般	negative
昨下午终于在年购买胶片单反镜头之后	neutral
闪光灯就算了肤色偏黄	negative
画面质量仍可以接受	positive
对焦点有点集中和开头的机器甚至开头的机器都不相符的塑料卡口	positive
正面太滑价格对我来说也贵了	positive
我开始也是在这两里选	neutral
虽然是固定的	neutral
人脸识别识别率木有手机或者强	negative
拍出来的照片色调有些奇怪主要是最小光圈只到	negative
价格对我来说也贵了只不过应该会耗费不少电力吧	negative
连续自动对焦的速度是最差的手柄突出部分和镜头对焦环之间的空间挤了点	positive
因此基本不存在跑焦的问题	neutral
感觉是	neutral
拍摄的照片看起来都是暴光正常的．	neutral
入手的	neutral
小拇指依然可以牢牢挂在机器上	neutral
不太可能是处理器运算速度太低	neutral
边角画质也很好	positive
优点	neutral
拍的好像蒙了一层雾自动对焦较慢	negative
喜欢它的小巧而已	neutral
没有防水防尘的噪点属于比较大色斑	positive
加上重心位置的问题	neutral
就是周边光量校正	neutral
感动在镜头上	neutral
对焦叽叽的叫声让你觉得随时要坏对焦精度太差了	negative
照片格式是精细的状态下拍摄所能达到的	neutral
除了颗粒感也挺好用的	positive
炒冷饭就是快门声音不怎么样	positive
除了价格比较高一些手感操控性能画质已然全面落后	negative
最最主要的是	neutral
体积不算小	neutral
只要它的下一代	neutral
实在太暗就放弃吧	neutral
但便携机在图像质量上总是稍欠缺一点还有不能换镜头局限了拍摄题材没有任何提示和显示	positive
供大家参考	neutral
按键按起来啪啪响只有一个外置接口	negative
不管怎么说	neutral
附带的解软件解出来的效果非常差的电子技术确实不高不深	positive
单点对焦试了几张也不好逃出紫边	negative
用了宾得好几年了	neutral
其余的对焦点的确的背景虚化不太好做	positive
还有就是确实存在严重的屏偏绿的问题说明他的电子设计和技术较低端	positive
松下万都多了	neutral
以前很多人都说的机身差机背液晶屏竟然是塑料的	negative
或者是夜景手动对焦	positive
不是更好吗	neutral
手感操控性能画质已然全面落后窃以为还是的软件功底差了	negative
录像按钮的我一会不敢超过	positive
防抖没有想像中管用全副镜头在上广角损失严重	negative
同样用测试对焦闪光灯就算了	negative
希望大家把眼光转向技术层面	neutral
快门打到尽然有重影就是成像似乎不像是微单的水平	negative
片子发暗种种现象接图的效果也不如	negative
人脸识别识别率木有手机或者强防尘不好	negative
先下结论	neutral
稳定性照电子快门线和遥控器差的多价钱不算低	negative
后来为了参加一些外拍活动	neutral
把机器竖着立起来	neutral
通过拍调整后好很多	neutral
他说摄影不是单纯的拍照	neutral
大概微距本来容易过曝	neutral
相信很多人吐槽的超高像素	neutral
拍出来白蒙蒙的但在大光圈长焦和闪光灯上还有不足	negative
除了价格比较高一些有时在长焦段会有拉风箱现象	negative
而腾龙出片我个人感觉比较像一个数码记录图像对于有人说它是塑料机身	positive
说下手感很给力	positive
	neutral
接图的效果也不如速度奇慢	negative
担心长久如此影响寿命	neutral
就感觉出来的片子更糟就是成像似乎不像是微单的水平	negative
拍摄起来我耳闻的高感比的给力了	positive
用卡	neutral
已经拍了些照片了	neutral
相当不错	neutral
镜里观察到的就是直接成像的效果	neutral
材质半金属半塑料	neutral
所以后来更新固件时加上了暗角减轻功能	positive
但是阳光下的远景分辨率说句不好听的就像手机拍的一样而且紫边也不小格式连拍坑爹	negative
不用闪光灯	neutral
就果断上	neutral
功能等功能对于老鸟可能无视	positive
也就是一个升级了传感器的	neutral
没有确实有点影响出片率手感操控性能画质已然全面落后	negative
画质出色是毋庸置疑的	positive
喜欢拍人像	neutral
机器内闪只有对焦速度还稍微跟不上	positive
改变成对焦辅助	neutral
二来也不显旧	neutral
小黑虽然部分焦段锐度跟不上快门延时稍长	negative
所以让人感觉塑料感稍重电池续航能力一般	negative
所以就暗暗下决心买一台单反备机	neutral
外出旅游的时候	neutral
一用机体验	neutral
说说我不太喜欢的几个小地方吧	neutral
是伪头种种	neutral
我发现的色彩非常干小五就成打酱油的	negative
典型的空气切割机	neutral
便宜好用的自动镜头少刚上手觉得操作特别困难	negative
目测对焦速度慢于只不过应该会耗费不少电力吧	positive
对焦速度慢这个完全不能和单反比啊塑料前脸仍然没有升级成合金材料	positive
的确的背景虚化不太好做用的时候快门声音很怪	negative
资金充足尽量买	neutral
买回来后感觉再小点就更好了	neutral
都是公家的机器不是自己的	neutral
与接近	neutral
后面陆续上传照片	neutral
由于倍光变	neutral
手感操控性能画质已然全面落后	negative
奥巴的机器握感都不好的电子技术确实不高不深	negative
与上几代比较进步的地方	neutral
不上照	neutral
感觉在变焦的时候有些迟滞最大的问题是为小体积而小体积	negative
镜头突出很多压缩比有些点	positive
对焦框不会显示稳定性照电子快门线和遥控器差的多	positive
但是屏幕实在不堪入目的对焦屏比较简单的感觉	negative
点点十字壮观	neutral
如果你看过评测的话	neutral
新一代暗处色彩丢失可能是因为噪音太大导致严重降噪抹除了颜色只有从机顶看觉得造型怪异些	negative
等孩子出生了	neutral
优点	neutral
快门声音比我想象的大得多对焦真的没什么优势	positive
原来的小机器想获得浅景深几乎是不可能的	neutral
而且其实技术含量不高	neutral
也是如此的设计屏幕太破了	negative
高象素	positive
机身轻小后的缺陷装个都觉得头重脚轻对焦速度是目前单电系统软肋	negative
但是很满意	neutral
能不能优先光圈变大	neutral
一直在用高端	neutral
各种功能齐全	neutral
但是强劲的机能会弥补画质的不足基本没用	negative
肤色偏金黄色	negative
就是对焦前先来回抽一下让人蛋疼配长焦机身偏小	negative
只有机身是熟门熟路	neutral
明明有怎么轻巧的机器	neutral
对焦尚可	positive
只能坚持的机器	neutral
高性能的完全大材小用	neutral
也就不会出现在洞妖的菜单内了	neutral
其次是那个主拨盘	negative
不过因为时间紧促没能好好试验一下	neutral
只是属于最严重的一类致命的阳光下看不清屏幕	positive
是菜单的灵活性赢	positive
除了价格比较高一些不如做工好	negative
作用有限被遮挡了大部分的光对于饼干/公主啥的	neutral
怎么都不嫌快	neutral
算了	neutral
机子太小太轻	negative
但是也完全没有不可用我不常拍运动的对象相信常拍运动题材的朋友也不会买所以不要拿这个来说事	neutral
快门声音比我想象的大得多感觉手柄还是略小	positive
	neutral
炒冷饭就一姐夫机的大小	negative
在众多影友的见证下	neutral
目前还没有配的既小巧又足够强大的闪光灯压缩比有些点	negative
全片幅外加镜	neutral
价１４０元５	neutral
的感光元件很出色	positive
个人很喜欢机背的按钮布局	positive
手感操控性能画质已然全面落后正面太滑	negative
比如确实有一定的进灰问题特别是电池舱盖	negative
配合大光圈	neutral
国内行货价格会是在元左右	neutral
我的感觉是更适合进行微距室内摄影	neutral
但在完全可以接受的范围	neutral
用了挺方便	neutral
屏幕用这么差的材料这头的对焦环	negative
现在我更喜欢的操作风格	positive
外盖分成了三部分单点对焦试了几张	negative
后来瞥到旁边的	neutral
但是便携性较差整体感觉就是一入门机的样子	negative
结果对焦和色彩让人失望肩屏小了些	positive
问题是体积也没见小啊手感操控性能画质已然全面落后	positive
价格相对昂贵存取慢	negative
而用户	neutral
白平衡新一代暗处色彩丢失可能是因为噪音太大导致严重降噪抹除了颜色	negative
总结	neutral
对焦框不会显示但是便携性较差	positive
而且不知道为啥	neutral
虽然在强度上有些降低高感有说不如的	positive
存取慢价格相对昂贵	positive
今天一早就去了内罗毕国家公园	neutral
配置一般机子太小太轻	negative
是一部很好玩的机器	neutral
但驱动有点慢手柄也太小	positive
配合减震系统	neutral
对焦速度一般没有闪光灯	positive
防抖是一直开着	neutral
画质不是锐度	neutral
新设计的镜头也比前面的口镜头都要小巧	positive
外拍要带够块电池	neutral
在肩屏的信息显示量上也不够丰富	negative
还有品控问题反光板污点门而腾龙出片我个人感觉比较像一个数码记录图像	positive
风景摄影表现一般机械快门线的确蛋疼	negative
也用过光圈优先	neutral
二是是否缩片	neutral
优点	neutral
最近拿到了	neutral
不过实际使用下来	neutral
发现对焦速度有所降低整体感觉就是一入门机的样子	negative
很多色友抱怨性能缩水	neutral
画质表现应该是不错的	positive
在网上也看了许多其他机型的样张非官方的	neutral
换机子就是直接上全副了	neutral
机身缝隙稍大镜头突出很多	positive
键	neutral
未必准确	neutral
肩屏显示的信息很多	negative
现在还在抓紧熟悉菜单设置过程中	neutral
入手已一个多月了	neutral
快门延时稍长手感操控性能画质已然全面落后	negative
随便一带就出来了很不好	neutral
真心觉得	neutral
现在的按键用起来不爽但因为绿屏问题实在让我觉得膈应	negative
虽然在强度上有些降低	negative
可以说在里数一数二	neutral
翻转屏	positive
光线暗的时候对焦拉风箱也没专业	negative
机身轻小后的缺陷装个都觉得头重脚轻的机身依旧采用工程塑料	positive
就只能用低速连拍了	neutral
拿到手上	neutral
对焦速度偏慢这景深伤不起	positive
但是	neutral
价格贵不少	negative
对我来说是缺点	neutral
虽说不太认同感动家的机身设计电池续航能力一般	positive
拍出来的照片色调有些奇怪	negative
但是便携性较差快门打到尽然有重影	negative
而且从来都是玩的机器	neutral
同样快门速度无摄像功能	positive
但我宁可这样也不要糟糕的做工开机慢大概秒以上	positive
总之	neutral
画面比细腻	positive
更庆幸没有掉入器材高烧者的行列	neutral
只不过应该会耗费不少电力吧档有问题	negative
非常成功的设计	positive
使用感受	neutral
对焦的确非常非常慢光学取景器聊胜于无	positive
你可以选择一个对焦点	neutral
底部没有皮面	neutral
美元的Ⅱ套机无疑是最有利的竞争资本	neutral
只是控制和手感恐怕没有这么舒服几个小按钮的感觉也是如此	positive
有遥控感应器	positive
和微单一样	neutral
快门延时稍长为什么照片这么小	negative
机身塑料感强轻	negative
但我没有在包装里面找到高清视频线长焦端光圈显得小了些	positive
现在洞妖就一直放着	neutral
所以握持时可以感觉手和机身不易随便改变姿势	neutral
完全可以胜任大部分可以做的事情	neutral
其实拿在手里久了觉得也挺好的	neutral
实际使用感受	neutral
抚摸了下/////	neutral
日益提高自己	neutral
很满足	neutral
似乎码率不够稳定性照电子快门线和遥控器差的多	positive
再拿是比较痛苦的	neutral
从原理上解释了洞妖的高感能力为啥要比小五好些个	positive
细抠的话可能快一点点	neutral
炒冷饭现在的按键用起来不爽	negative
我的总是接着外置的电子取景器	neutral
我总觉得这样不能锻炼自己的构图	neutral
如果没有的	positive
说一下使用感受吧同相比	neutral
比好用许多	neutral
总体上给我的感觉这套系统对焦性能和差不多但体积不小	negative
的	neutral
操作够复杂的只是控制和手感恐怕没有这么舒服	negative
操作么	neutral
操作的时候小里小气的闪光灯就算了	negative
而它极轻的快门声音和微小机震几乎是我所使用过的数码单反中控制的最好的	positive
在这些方面会好很多吗	neutral
万像素图像感应器	neutral
就是紫边太严重结果对焦和色彩让人失望	negative
密封不好等看着取景器里的对焦点从模糊清晰模糊清晰的过程的确有砸机冲动	positive
不过感觉快门很涩体积太大	negative
色彩灰暗同样快门速度	negative
录像按钮转盘和那个十字大按键有些容易误操作	negative
但在自动对焦操控感受上还存在一定差距	negative
看着取景器里的对焦点从模糊清晰模糊清晰的过程的确有砸机冲动的确的背景虚化不太好做	negative
但对色彩的处理还不如众老厂经验丰富先对焦后构图速度太慢且容易焦点偏移	negative
各位不喜勿喷	neutral
总体上给我的感觉这套系统对焦性能和差不多我最不满意的是那个删除键	positive
不过感觉快门很涩的确的背景虚化不太好做	negative
套装	neutral
高感就不要太奢求了机背液晶屏竟然是塑料的	positive
有个拍过和的对比照	neutral
是不是	neutral
但是屏幕实在不堪入目	negative
用屏幕取景的时候感觉包括声音什么的都有点像	neutral
只是开电池舱盖和卡舱盖的时候能明显感觉到塑料的做工但是感觉跟还是有一定差距的	positive
的画质可以用赏心悦目来形容	positive
拍了就中	neutral
不过也还是有不少镜头可以选择	neutral
让我下决心买它的原因	neutral
而且比较慢	neutral
感觉	neutral
实用感觉就是很流畅	neutral
人脸识别很好	positive
但是的出世	neutral
跟第点一样	neutral
无疑是一个大好消息	neutral
自动对焦较慢小五就成打酱油的	negative
所以我觉得是不错的选择	neutral
没有开机的体积真是小得可以	positive
白平衡但是屏幕实在不堪入目	positive
配长焦机身偏小手感操控性能画质已然全面落后	negative
但可以接受	neutral
外观变丑了左上角的拨盘看上去仍然很幼稚	positive
虽然运转完好	neutral
是性能优秀	positive
机内软件可能有问题首先是那个和啤酒瓶子盖一样的模式转盘	negative
用了一组快的低通	neutral
夜拍一次街景	neutral
就一姐夫机的大小光线暗的时候对焦拉风箱	positive
寸万象素的液晶屏有点落伍了手柄也太小	negative
现在的按键用起来不爽	negative
现在已可以放心用到	neutral
价格相对昂贵左上角的拨盘看上去仍然很幼稚	negative
作为元价位的中专端机其性能还是非常优秀的	positive
你总感觉的倍变焦是骗人的但便携机在图像质量上总是稍欠缺一点还有不能换镜头局限了拍摄题材	negative
价格贵不少但是感觉跟还是有一定差距的	negative
看来金属骨架工程塑料的做工还过得去本人只用过和手感是与这两部机来对比的	neutral
可惜吗	neutral
只是手感上的不同而已	neutral
对焦速度一般机械快门线的确蛋疼	negative
高感宽容	neutral
我的和这两位比起来	neutral
但是就凭这个外观	neutral
真是台强制我不要乱按快门的好机器啊镜头方面也有不足的地方	negative
第二梯队中快于	neutral
的遮光罩为什么总是做的很松在肩屏的信息显示量上也不够丰富	negative
已经昭显的出世	neutral
的对焦屏比较简单的感觉对焦点有点集中	negative
决定权交给了你	neutral
机身缝隙稍大单点对焦试了几张	negative
都不需要进菜单设置	neutral
自动对焦释放优先	neutral
玩了半年就出掉了主要是边缘成像太差色散严重可是它的机械性能又实在是不好	negative
镜头是腾龙	neutral
可能机身比较厚的缘故吧	neutral
删视频就更加了	neutral
洞妖的明显要慢于的没有防水防尘	positive
前几天入了一个二手	neutral
就是成像似乎不像是微单的水平	negative
就是的色散比重引起的塑料前脸仍然没有升级成合金材料	negative
软件不太好使/的快门大家都非常郁闷	positive
这样便于拍摄构图	neutral
色彩不偏差就是紫边太严重	negative
爱不释手	neutral
说明他的电子设计和技术较低端	negative
快门声音比我想象的大得多也有紫边	negative
的对焦外观既没有时尚	negative
和是最纠结的	neutral
续航	neutral
不过握感上还是有区别的	neutral
调整比较方便	neutral
一直很喜欢它的锐利度色泽与对焦速度	positive
我认为是必须的	neutral
但用了几个月之后	neutral
入手的简单感受	neutral
重量较轻	positive
防尘不好画质没有什么出彩的地方	negative
挑很多毛病	neutral
单位的	neutral
价格估计在这两之间	neutral
谈点感受	neutral
除了价格比较高一些导致无法进行连续拍摄	positive
寸万象素的液晶屏有点落伍了但对色彩的处理还不如众老厂经验丰富	positive
那感觉和效果是脚底抹油也赶不上价格对我来说也贵了	negative
有人脸对焦了	positive
给想入手的您	neutral
第一梯队还是和	neutral
对焦点不行啊不过手感一般	positive
我也是中招的	neutral
直出太差了这么密的小像素	negative
相信此次个人使用的款镜头也非入门等級	neutral
真不觉得可以值港币的售价折合	neutral
将原来机背速控转盘旁的开关键改为机顶	neutral
没有遇到跑焦的问题	positive
不就好看多了	neutral
缺点	neutral
液晶屏像素太低洞妖的明显要慢于的	negative
肩屏显示的信息很多自动对焦较慢	negative
与我之前的备机想法完全背离	neutral
写入速度达到/秒	positive
和开头的机器甚至开头的机器都不相符的塑料卡口有时候界面操作都会有些许延时现象	positive
/的外观已经有了很大变化	neutral
几年里面	neutral
洞妖的明显要慢于的	negative
看来松下的镜头有认证还是真的	positive
从上来有些不习惯	neutral
重量重不少片子发暗种种现象	negative
价格对我来说也贵了也有紫边	positive
然后仔细端详把玩	neutral
速度奇慢档的超级功能木有了	positive
完成构图后重新半按快门	neutral
色泽与可视角表现也佳	positive
没有防水防尘玩了半年就出掉了主要是边缘成像太差色散严重	negative
松下的对焦速度太爽了	positive
左上角的拨盘看上去仍然很幼稚主要是最小光圈只到	positive
郁闷	neutral
手动对焦有就感觉出来的片子更糟	positive
谢绝人身攻击	neutral
不过手感一般左上角的拨盘看上去仍然很幼稚	negative
色彩不够鲜艳但体积不小	negative
自动白平衡在某些特定场合容易出錯和的比似乎就少了点相位对焦点	positive
但是强劲的机能会弥补画质的不足	positive
骚是绝对骚的	neutral
而新型菜单则是要通过更多的页面切换来选中想要的设置的项目	neutral
长焦端光圈显得小了些所以设计理念上不高明	negative
屏幕用这么差的材料主要是因为色散控制不好的原因	negative
的对焦屏比较简单的感觉不喜欢闪光灯的设计	negative
加锐利度也沒有太大帮助	neutral
肤色偏黄发现对焦速度有所降低	positive
终于那没人了	neutral
现在空气污染厉害	neutral
所以设计理念上不高明的对焦屏比较简单的感觉	negative
变得很丰富	neutral
手感操控性能画质已然全面落后电池太渣	negative
再看一屏	neutral
手柄突出部分和镜头对焦环之间的空间挤了点	negative
全副镜头在上广角损失严重除了价格比较高一些	negative
不得而知	neutral
这特么是多爽的一件事啊	neutral
因此背景的虚化不足的噪点属于比较大色斑	negative
而且定价太高了	negative
液晶屏无法关闭盲拍色彩不偏差	positive
各人所爱吧	neutral
每秒张连拍应该足够适合大多数人吧	neutral
和的高感成像质量相比较而言就有些惨了可能握持上不是太舒服	positive
系列年不变的低调外形	positive
但是长焦是外变焦除了没有触摸屏以外	negative
连续自动对焦的速度是最差的微距自动对焦较慢	positive
想问问为什么的照片这么小啊对焦太慢了	negative
旧机拍风光总觉得象素不够用	neutral
期间外出拍摄次	neutral
对焦点选择不是很方便和的高感成像质量相比较而言就有些惨了	positive
暂时说这么多	neutral
也许	neutral
虽说不太认同感动家的机身设计但是强劲的机能会弥补画质的不足	negative
谈谈感受	neutral
夜景画质很一般但体积不小	positive
辅助灯距离比较近	neutral
寸万象素的液晶屏有点落伍了存取慢	negative
不像	neutral
就说明对准了	neutral
阳光下拍出来很正常	positive
手动对焦有也不好逃出紫边	positive
在的车上很颠簸	neutral
现在的屏幕裸露在外画面也惨不忍睹	negative
每秒张连拍并且机震极小的优秀机身	positive
可是它的机械性能又实在是不好键位设置不如全副方便	negative
不过对于外观和手感	neutral
但在重量上却减轻不少机身重克机身重克	positive
出来的片子更糟没有内闪	negative
这个镜头的成像还算不错	positive
相机的取景器可谓是相机的眼睛	neutral
另外高感也差很多对焦真的没什么优势	negative
对焦真的没什么优势肤色偏黄	positive
所以一直没什么机会好好用这功能	neutral
我相中该机器的	neutral
但是长焦是外变焦但因为绿屏问题实在让我觉得膈应	negative
一心想购的	neutral
足够可以满足大家的平时要求	neutral
还有就是确实存在严重的屏偏绿的问题速度奇慢	negative
真心俗啊	neutral
在肩屏的信息显示量上也不够丰富亮度还是偏低	positive
但是在一米左右的背景也虚化的可以了	neutral
所以我需要内闪	neutral
的优点都有评论	neutral
还是极好用的	neutral
也就是宁愿过曝也不要欠曝	neutral
最不满意的也就对焦系统了对焦框不会显示	negative
档有问题	negative
屏幕用这么差的材料但我宁可这样也不要糟糕的做工	positive
下午在上海星光试玩了新机	neutral
外观变丑了单点对焦试了几张	negative
但是长焦是外变焦主要是高清视频录制清晰度差	negative
很好用	neutral
这搭配很有点丐帮高手的意思	neutral
一会儿担心构图	neutral
细抠一下	neutral
但在基本的锐利度表现对强光源的处理不好	positive
的工业设计到底怎么了的确的背景虚化不太好做	negative
你注意她的紫边和虚就行了	neutral
除了屏只能上翻度	neutral
对焦速度慢白平衡	negative
快门延时稍长切机身严防磕碰	negative
特别是在对夜景的时候	neutral
网络上许多讨论与画质测试依然相当出色	positive
的操控很不一样	neutral
想问问为什么的照片这么小啊但在大光圈长焦和闪光灯上还有不足	positive
色彩感觉没有原来的容易调整对焦点的选择也略蛋疼	positive
右一串按钮并不美观	neutral
然后把线缆插到机身上的插口里好得多	neutral
丰富的功能	positive
和开头的机器甚至开头的机器都不相符的塑料卡口拍出人物的皮肤较硬	negative
说明他的电子设计和技术较低端问题是体积也没见小啊	positive
甚至比大马三的表现好就是其最大的优势	neutral
我在想	neutral
也不好逃出紫边对焦点不行啊	positive
	neutral
比如确实有一定的进灰问题对焦点选择不是很方便	negative
几个小按钮的感觉也是如此	negative
而是将最底层的选项直接放入主菜单当中	neutral
对焦点有点集中塑料前脸仍然没有升级成合金材料	negative
电池太渣操控缩水	positive
看到网上有很多摄友评论的对焦什么的不输	neutral
一机一镜打算好好拍片	neutral
使用不会让你失望	neutral
存储速度慢就说下设计上的不足	negative
郁闷	neutral
键位设置不如全副方便所以让人感觉塑料感稍重	positive
应该会买	neutral
和手里那台三星比起来先输一筹	neutral
洞妖的处理器应该明显快于小五的	positive
现在是点自用对焦	neutral
本就烦这种逆潮流的缩水机	neutral
除尘功能到底如何	neutral
对卡的速度要求高	neutral
瞬间震撼了	neutral
从价格上就没怎么关注	neutral
价格也最高但体积不小	negative
和/像质好是好	positive
因为如果以后使用/的镜头在晴天下全开光圈使用	neutral
如东芝的	neutral
当时图便宜给买了几个	neutral
相关照片慢慢不上	neutral
那感觉和效果是脚底抹油也赶不上出来的片子更糟	negative
快门触感变深	negative
很多快捷键都给阉割了	neutral
相对于自家的来说	neutral
也强出不少	positive
就是紫边太严重这头的对焦环	positive
很多人觉得造型很怪异左上角的拨盘看上去仍然很幼稚	negative
他可以/档的调整	neutral
这么小的电子问题都长久没解决	neutral
但是便携性较差电子取景器有时滞	positive
的手感特别好	positive
从没想过的高感会做的如此优秀跟还是比不了了	positive
我很少用	neutral
反差较小时镜头还会拉风箱的感光度在的时候也只能说勉强凑合看	positive
绝对胜出	positive
压缩比有些点重量重不少	positive
有有	neutral
价格一半以下	positive
用的时候快门声音很怪键位设置不如全副方便	positive
会很大程度上增加你摄影的视角范围和乐趣	neutral
α	neutral
没有快门声的清脆	positive
不过用的次数却很少	neutral
但因为背着近公斤的负重和单反相机	neutral
本来很看好这款类的机子	neutral
估计流行起来以后淘宝上会出来一大堆仿造的呵呵	neutral
除了没有触摸屏以外最大的问题是为小体积而小体积	negative
下面附点样片	neutral
与其他厂比毫不逊色	neutral
设置相当的细腻	positive
把开关和速控转盘锁止键分离开来也减少了误操作的机会	neutral
画面也惨不忍睹价格贵不少	positive
在调整曝光模式转盘时发现采用了防误拨设计	neutral
亮度还是偏低的工业设计到底怎么了	negative
对焦烂也就算了对对焦点的明暗反差要求比较高	negative
同样快门速度自动白平衡在某些特定场合容易出錯	negative
从到到到到	neutral
它的电子手动对焦很好用	positive
防尘不好夜景画质很一般	negative
对焦好	positive
让那些用的女士双臂平伸端着手感很差的克重物显得那么滑稽可笑同样快门速度	positive
比如确实有一定的进灰问题	negative
再说主观感受哪些地方得到提升	neutral
对焦点有点集中总体上给我的感觉这套系统对焦性能和差不多	positive
没有确实有点影响出片率此头焦外绿边十分严重	negative
对焦点的选择也略蛋疼机身塑料感十足	positive
我的手不大	neutral
似乎码率不够带来的问题就是握持感	negative
机身塑料感十足的感光度在的时候也只能说勉强凑合看	negative
后来家里不幸失窃	neutral
其他都出掉了	neutral
操作系统反映速度很慢画面颗粒感较强	positive
因为全兼容宾得的镜头	neutral
但在大光圈长焦和闪光灯上还有不足主要是最小光圈只到	positive
全电子控制对焦环和光圈也算了	neutral
公文包就可以轻松放进去	neutral
不如做工好手感操控性能画质已然全面落后	negative
不仅取决于机身	neutral
但存入照片有延时	neutral
对卡的要求	neutral
虽然在强度上有些降低全副镜头在上广角损失严重	positive
俺以前从未把一部单反长时间放在电脑前	neutral
色彩不偏差最不满意的也就对焦系统了	negative
真的很清楚	neutral
色彩	neutral
成像锐利样机上是的头	positive
金属部件的	neutral
电池太渣拍出来白蒙蒙的	positive
所以	neutral
各位看官可能都累了	neutral
但是此时对焦成功率比高太多太多了	positive
对焦上面	neutral
存储卡仓盖上也包覆了蒙皮	neutral
每次都会无意中碰到对焦环	neutral
对焦太慢了一是太小完全不像是消费专业级数码相机的水平	negative
让那些用的女士双臂平伸端着手感很差的克重物显得那么滑稽可笑没有	negative
试用了佳友在线提供的加/套装	neutral
的宽容力可以理解为高画质带来的构图宽容	neutral
长焦端光圈显得小了些	negative
塑料感强也没专业	negative
可能握持上不是太舒服但是外挂电源毕竟影会影响的便携性	negative
景深预览键没有不过与相比的机身确实短了一些从左到右方向	positive
放家里看看都值得	neutral
这点我非常喜欢	neutral
不仅的镜头用在全画幅机身会有暗角	neutral
加上年度双十一的时候	neutral
实际操作	neutral
结果对焦和色彩让人失望高速卡帮助不大	negative
无法自动对焦	neutral
不过随着下半年进入战国时代	neutral
没滤镜可不敢到处扛着跑	neutral
像素密度太密了感觉看不出噪点	positive
总的来说用来拍人像肤色怪怪的可能握持上不是太舒服	negative
最后来一张天桥上的	neutral
这个确实有	neutral
肩屏小了些也不好逃出紫边	negative
完全没有发挥半透镜优势的对焦张/秒的连拍速度结果对焦和色彩让人失望	positive
前面说过	neutral
就是	neutral
但是像素比较低现在觉得我完全不需要高像素这点下面我会解释我觉得的机身手感很不理想	positive
很不好用不如	neutral
手感操控性能画质已然全面落后细节较多	negative
多数性能优于或者等于	positive
所以让人感觉塑料感稍重画面颗粒感较强	positive
拍出来的效果是一样的	neutral
但只要墙上有一点点肉眼可见的细微瑕疵	neutral
真是台强制我不要乱按快门的好机器啊一是太小完全不像是消费专业级数码相机的水平	negative
其他市场上的都是带功能的	neutral
对焦速度偏慢对焦速度还稍微跟不上	negative
其余角度都挺正统的	neutral
价格贵不少只是控制和手感恐怕没有这么舒服	negative
很实在哦	neutral
玩过单反的都知道这样的焦距	positive
就感觉出来的片子更糟	negative
画质素质不俗	positive
口水啊	neutral
就是快门声音不怎么样	negative
对焦速度一般机子太小太轻	positive
的储存比前任已有很大进步	positive
容易滑动	neutral
的遮光罩为什么总是做的很松和的高感成像质量相比较而言就有些惨了	positive
也没专业目前看感觉照片效果不如上周买的的松下	positive
试拍了两张	neutral
为什么呢	neutral
如果有全时手动对焦时间最少缩短一半	neutral
小黑虽然部分焦段锐度跟不上但在大光圈长焦和闪光灯上还有不足	negative
使得防滑性更好	positive
对焦相当靠谱的	positive
理论上控噪能力会提升	positive
意味着	neutral
配长焦机身偏小可是它的机械性能又实在是不好	negative
大名鼎鼎的倾情奉献	neutral
三星最爽的是手头那颗饼干头	positive
结果对焦和色彩让人失望看着取景器里的对焦点从模糊清晰模糊清晰的过程的确有砸机冲动	positive
但我只有块钱	neutral
用的时候快门声音很怪我发现的色彩非常干	positive
色彩不够鲜艳但我却很喜欢真实的色彩	positive
这句话很适合用数码相机的人	neutral
反差较小时镜头还会拉风箱尤其是曝光锁定键	positive
对焦叽叽的叫声让你觉得随时要坏机内测光容易出错导致过曝	positive
可以玩一下	neutral
尤其是相对于手头预算较紧的人群来说	neutral
相对一样的显示屏	neutral
岁多走路很快	neutral
不满的是反映速度这个头的对焦性能并不好	positive
对焦太慢了对焦慢	positive
真是台强制我不要乱按快门的好机器啊暗部对焦拉风箱	negative
只有照片文件	neutral
机器内闪只有所以让人感觉塑料感稍重	negative
准备进入世界探究一番	neutral
如今拿到这部强大的双核安卓手机在把玩里被吸引了	neutral
都被鄙视	neutral
而且就目前的资料来看	neutral
连拍很给力哦	positive
而是希望论坛里的朋友们对新发布而又没有达到自己预想的机器抱一个端正的态度	neutral
就是不太方便机身轻小后的缺陷装个都觉得头重脚轻	positive
关于	neutral
片子发暗种种现象肩屏显示的信息很多	positive
在取景窗的旁边少了取景框线的采光窗	neutral
让拍摄角度有很大的扩展	neutral
内存里照片拍到个张以后	neutral
携带感/操控感	neutral
特别是电池舱盖变焦感觉有点慢哦	positive
以对焦操控见长	positive
后者就是过去产品用的模式	neutral
松下出来的图片的比对度的确有点不够在暗处对焦边缘对焦点无力	positive
在暗处对焦边缘对焦点无力似乎码率不够	negative
虽说不太认同感动家的机身设计广角端边缘锐度不行	negative
不过对焦嘛	neutral
浏览画面是是润饰菜单	neutral
这在无反相机中是独树一帜的	neutral
自我感觉一点不输	neutral
洞妖的功耗远小于小五的	positive
并且它还有闪灯插口	neutral
只有一个外置接口塑料前脸仍然没有升级成合金材料	negative
有时候界面操作都会有些许延时现象不喜欢闪光灯的设计	negative
存取慢底部材料没有改进	negative
让它站在微单旗舰旁边气场也不落下风	neutral
但我却很喜欢真实的色彩感觉在变焦的时候有些迟滞	positive
我喜欢这种效果	neutral
自动连拍然后合成只能	neutral
本帖前面楼那位仁兄说的真不假	neutral
这个也是我非常看重的方面	neutral
《新机试用感受宾得	neutral
对焦速度还可以	positive
格式是专业卡片机必备的性能	neutral
这次有幸在的支持下试用到这款相机	neutral
没有机内除尘是个问题外接闪光灯真丑	positive
拍摄时基本没啥拖沓	neutral
测试了手上所有的镜头	neutral
总的来说用来拍人像肤色怪怪的目前还没有配的既小巧又足够强大的闪光灯	positive
用起来比看起来要顺心	neutral
肤色偏黄软件不太好使	negative
其次是那个主拨盘白平衡	negative
边缘对焦还是比较容易拉风箱对焦慢	negative
最烦人的是不能全时手动肤色偏黄	negative
明显敌不过但是阳光下的远景分辨率说句不好听的就像手机拍的一样而且紫边也不小	negative
尤其拍微距够毒	positive
色彩感觉没有原来的容易调整	negative
高感情况下	neutral
设定在拍照模式时	neutral
再说说具体感受吧	neutral
感受在对焦的时候有些犹豫因为经常看到有人说的声音一塌糊涂	negative
比如白平衡没有显示外观变丑了	positive
最后一狠心	neutral
与电脑显示效果相差不多	neutral
热靴口变成了通用的	positive
感觉极其完美	neutral
总的来说用来拍人像肤色怪怪的肩屏小了些	negative
这只镜头配合起来就有点问题电池续航能力一般	positive
照远景效果比许多机子差就是对焦前先来回抽一下让人蛋疼	positive
先说一下的外观	neutral
对焦比较快速准确	positive
如果你拍的是大人	neutral
凭什么和不通用	neutral
颜色也更为厚重些	positive
并不连续	neutral
好处是	neutral
只是控制和手感恐怕没有这么舒服目前还没有配的既小巧又足够强大的闪光灯	positive
对得起那点银子	neutral
为持续工作减少了一些压力	neutral
当然	neutral
混合取景器	positive
用转接要好很多但又没有了自动对焦	negative
我每次用完都要放大查看	neutral
洞妖的明显要慢于的对焦慢	negative
咬咬牙上绝对不会后悔	neutral
档有问题广角端边缘锐度不行	positive
机顶塑料部件厚实有质感	positive
操控方面	neutral
一般口袋是放不下的	neutral
中心对焦点在暗光条件下的对焦能力更是远远的超过了	positive
其实有点夸张	neutral
放大衣兜里没有任何压力	neutral
暗处不刺眼	neutral
可玩性大大提高	positive
感觉看不出噪点用的时候快门声音很怪	negative
卡的剩余量以及相机的一些基本参数	neutral
完全可用	neutral
镜头突出很多	negative
而拍摄模式转盘也加了按键锁	positive
松下出来的图片的比对度的确有点不够价格对我来说也贵了	positive
有时不能精通选择对焦点	neutral
夜景手持真的很吃力开机慢大概秒以上	negative
用起长焦才知道自己身体不好	neutral
而远角端只有玩了半年就出掉了主要是边缘成像太差色散严重	positive
如果能有对焦微调只是开电池舱盖和卡舱盖的时候能明显感觉到塑料的做工	negative
色彩感觉没有原来的容易调整机身手感一般	negative
港货不到的价格	neutral
就是不太方便白平衡	negative
最令人满意的是它的成像了	positive
小五就成打酱油的出来的片子更糟	negative
的应该是足够了	positive
却是两只手都能用上	neutral
对焦准/测光准	neutral
若非我现在仍是抵制日货者	neutral
要想得到理想的效果	neutral
另三款差不多	neutral
其实这个地方的误操作几率不算太大	neutral
连拍到张左右会卡壳一下应该是相机缓存满了数据写卡	neutral
的镜头就不多提了	neutral
另外一点	neutral
非常期待α呀	neutral
	neutral
就说下设计上的不足对焦速度偏慢	positive
而非功能性的特点	neutral
在这里我给这个新功能鼓鼓掌	neutral
就是紫边太严重可能握持上不是太舒服	positive
分享一下几天使用下来感受	neutral
我个人觉得犯不上为了１００２００的差价弄个网购．．．	neutral
多种创意滤镜	neutral
写一下自己的感受	neutral
试机感受	neutral
机子太小太轻拍的好像蒙了一层雾	negative
可以触摸对焦	neutral
操作方面慢慢熟悉很方便没用过	positive
有人说没必要	neutral
而腾龙出片我个人感觉比较像一个数码记录图像机内软件可能有问题	negative
成像显著提升	positive
玩了半年就出掉了主要是边缘成像太差色散严重手感操控性能画质已然全面落后	positive
夜景画质很一般致命的阳光下看不清屏幕	positive
只是达到一定程度	neutral
坛里有人说要十几秒	neutral
自然而然的就要说一下了	neutral
外壳应该是铝合金的	neutral
问世到现在快十年了	neutral
比较清脆与相近但没有那么浑厚	neutral
不过买了就好好用吧	neutral
因为象素数量相差得太远	neutral
功能也比强了不少	positive
图实在太大了	neutral
感受在对焦的时候有些犹豫的机身依旧采用工程塑料	negative
唯一缺点	neutral
恨不得张张/	neutral
喜欢旅游的建议买原厂的银广角	neutral
手柄突出部分和镜头对焦环之间的空间挤了点没有	negative
存储速度慢也不好逃出紫边	negative
关于升级之前一直用的是相机	neutral
第一梯队还是和	neutral
进过一段时间的拍摄	neutral
做工不错	positive
因为连拍是坑爹	neutral
就是不太方便正面太滑	negative
谈谈初步感受	neutral
无摄像功能	negative
平时在家里或附近把弄练手	neutral
拍出人物的皮肤较硬	negative
只拍会快很多	neutral
行货码合一	neutral
但色彩略差于最不满意的也就对焦系统了	negative
就说下设计上的不足转盘和那个十字大按键有些容易误操作	negative
平均每个月能使用次相机拍摄录像	neutral
小五就成打酱油的	negative
对焦方式	neutral
那种细腻的感觉的确很赞	neutral
这里仅仅说一句	neutral
手感操控可玩性都具备了	positive
我说的缺点都是存在的	neutral
但驱动有点慢同样用测试对焦	positive
但在夜晚	neutral
想了很久	neutral
谢谢大家	neutral
搭个饼揣口袋	neutral
高感再好也不如光线好	neutral
附带的解软件解出来的效果非常差图象完全看不清楚	negative
可出来个还有	neutral
可以设定最低安全快门	neutral
但是就是太贵了	neutral
主要是因为这两个头性价比很高	positive
功能不如	negative
就是机器竖拍的照片	neutral
机身塑料感强轻亮度还是偏低	negative
我这次带的器材多为新买的	neutral
关于	neutral
光学取景器聊胜于无对焦速度慢	negative
视野率用起来也很放心	neutral
这两个都是不错的人像头	positive
装卸都很方便	positive
快门声音	positive
我曾一度习惯了把相机捧在腰间	neutral
微距自动对焦较慢全副镜头在上广角损失严重	negative
但是像素比较低现在觉得我完全不需要高像素这点下面我会解释就是的色散比重引起的	negative
充电感觉不是很方便	negative
机身前面的对焦模式拨杆	neutral
的做工较为出色	positive
我不是托	neutral
亮骚的外形	positive
高像素主要用在裁剪后放大	neutral
还有品控问题反光板污点门但体积不小	negative
旧机轻触快门对焦都可能将快门释放	neutral
金属机身	neutral
价钱不算低价格相对昂贵	positive
简单来说	neutral
玩过朋友的	neutral
但色彩略差于	negative
比如确实有一定的进灰问题手动对焦更慢一些	negative
五因为是广角	neutral
裤衩也变成了腰带	neutral
外观	neutral
自动对焦较慢玩了半年就出掉了主要是边缘成像太差色散严重	positive
感觉以为代表新机色彩趋向明艳	positive
旧机就存在这个问题	neutral
整个手柄能平衡一下重量	neutral
立刻能够识别出来	neutral
如果分辨率不足	neutral
就是心疼	neutral
但是对紫边的控制绝对是数一数二的	positive
直出太差了高速卡帮助不大	positive
但在自动对焦操控感受上还存在一定差距现在多出来的锁定键做的太	positive
光线暗的时候对焦拉风箱目前看感觉照片效果不如上周买的的松下	negative
六的手动对焦环是假的是对焦环不是变焦环它的手动变焦环很爽光学取景器聊胜于无	negative
首先	neutral
对焦点的选择也略蛋疼对焦叽叽的叫声让你觉得随时要坏	positive
屏幕太破了快门打到尽然有重影	negative
就只是怪的色彩没有机内除尘是个问题	negative
没有功能但是长焦是外变焦	positive
一最基本的	neutral
在那里痛苦的拉风箱	neutral
以前很多人都说的机身差连续自动对焦的速度是最差的	positive
直接出片机内处理锐度过头了点自动对焦较慢	negative
稍逊于单反的机械性能快门打到尽然有重影	positive
但是松下的镜头盖可以直接盖在镜上	neutral
口的胶片机有很多	neutral
然后就是专业级的消费相机了	neutral
在第一次用的时候就发现	neutral
对焦点的选择也略蛋疼	negative
简洁方便	neutral
中央五个对焦点很暴力我是从来不敢使用以上的感光度去拍人像的	positive
艺术效果拍摄时拖尾严重没有多次曝光功能	negative
快门声在体验时最想让我吐槽的就是它的快门声了单点对焦试了几张	positive
毕竟随身机器要多元化个人建议	neutral
不过对大光比的控制方面明显不如全副质量还不如以前的	negative
也不好逃出紫边如果能有对焦微调	negative
对可以拍摄夜晚灯光和运动物体效果很好	positive
试拍了几张	neutral
简单说功能较全	positive
反正也试用得很了	neutral
除了价格比较高一些就是一台没有电话功能	positive
外观既没有时尚感觉手柄还是略小	positive
对焦这东西	neutral
入手一些感受生活一些随拍	neutral
都赶不上像素的测光判断吧	neutral
不满的是反映速度机身手感一般	positive
出来的片子更糟	negative
自动/手动对焦随时切换	positive
但那对焦速度我是受够了带来的问题就是握持感	positive
α	neutral
变焦感觉有点慢哦比如确实有一定的进灰问题	negative
不是很好听	neutral
对焦速度慢六的手动对焦环是假的是对焦环不是变焦环它的手动变焦环很爽	negative
完全可用	neutral
我手大	neutral
大姆指和中指的配合比较多	neutral
辅助对焦也足够了	positive
亮度还是偏低	negative
没那么乱	neutral
因此背景的虚化不足对强光源的处理不好	negative
因为在我心中是一个相当经典的机型	neutral
按国外网上评测	neutral
的对焦目测对焦速度慢于	negative
但是长焦是外变焦没有多次曝光功能	positive
只是属于最严重的一类稳定性照电子快门线和遥控器差的多	negative
没啥质的差异	neutral
哈哈．	neutral
但那对焦速度我是受够了对焦速度是目前单电系统软肋	negative
我觉得的机身手感很不理想正面太滑	negative
而的平均是	neutral
毕竟是中端机嘛	neutral
那些说这款机对焦差得不能用样子丑没光学取景器什么的	neutral
功能等功能对于老鸟可能无视	positive
一点个人体会	neutral
所以不太清楚	neutral
性格鲜明	positive
如果是为了网络交流	neutral
的对比对焦显然没有的相位对焦快奥巴的机器握感都不好	positive
不过镜头光圈改变为	neutral
拍半身人像特写都很好	positive
锐度偏低	negative
用的时候快门声音很怪对焦真的没什么优势	negative
滤镜增加	neutral
如果不是抓拍的话	neutral
另外实时取景模式有触摸对焦	positive
的有大小	neutral
对焦框不会显示主要是因为色散控制不好的原因	negative
不知是不是也是这样	neutral
这比要实用多了	neutral
的手感虽然少了的厚重感接图的效果也不如	negative
随便拿出一台微单	neutral
前两天在马连道入手	neutral
体型都变大	neutral
对强光源的处理不好	negative
用好了也不错	neutral
的操作貌似跟是一样的吧	neutral
这样省去一大烦恼	neutral
对焦慢对焦烂也就算了	negative
有好几个兄弟在玩看来感兴趣的人很多品控做好必然神机啊	neutral
它相机里电池自行放电由来已久觉得电池续航能力很一般	negative
弱光下对焦:略胜出	positive
容我整理下思绪	neutral
跟大多数内敛型的那样	neutral
体积小尤其是曝光锁定键	negative
单电真是日益完善了	neutral
断货严重	neutral
功能不如基本没用	positive
玩了半年就出掉了主要是边缘成像太差色散严重	negative
画质没有什么出彩的地方特别是电池舱盖	positive
图象完全看不清楚就是的色散比重引起的	positive
底部材料没有改进对焦的确非常非常慢	negative
只有闲下来时带上机器四处走走拍拍	neutral
但是阳光下的远景分辨率说句不好听的就像手机拍的一样而且紫边也不小你总感觉的倍变焦是骗人的	positive
最后声明一下	neutral
但色彩略差于问题是体积也没见小啊	negative
夜景手持真的很吃力只有一个外置接口	negative
夜景手持真的很吃力但因为绿屏问题实在让我觉得膈应	negative
易摔落	neutral
便宜好用的自动镜头少我的就是最小的暗部噪点也清晰可见	negative
按说的镜头毋庸置疑那块万像素传感器也很不错	positive
轮换着用	neutral
觉得电池续航能力很一般操作系统反映速度很慢	negative
存储时间就相应短些	neutral
两者相差不多	neutral
发现也不难上手	neutral
先来说说优点吧	neutral
个人觉得做工不如但在自动对焦操控感受上还存在一定差距	negative
手拿这款机器	neutral
当然也没有特别暗的环境试验	neutral
但是显示效果还算不错	positive
因为我也越来越深刻的体会到一台相机的使用感受对于摄影创作是多么的重要	neutral
总体来说倾向于	neutral
存取慢	negative
顺便吐槽这几个新出的镜头格式连拍坑爹	negative
同的差不多	neutral
还有多重曝光和模式也大大方便了更多的拍摄题材	positive
屏幕太破了就一姐夫机的大小	negative
还好啦	neutral
试过边缘对焦和的比似乎就少了点相位对焦点	positive
手柄突出部分和镜头对焦环之间的空间挤了点顺便吐槽这几个新出的镜头	negative
奥巴的/镜头也是个大块头而腾龙出片我个人感觉比较像一个数码记录图像	negative
细腻	neutral
不如做工好也有紫边	negative
还有品控问题反光板污点门感觉机身的自动白平衡有点问题	negative
档里默认光圈是	neutral
中央五个对焦点很暴力个对焦框太大了	positive
没有键位设置不如全副方便	positive
和朋友的对比了下	neutral
目前价位还是高于的就是紫边太严重	positive
到现在已经有半个月了	neutral
随机附带的软件是	neutral
增加键前文也详细的提到	neutral
柯达画质最好都是年年之前的款	neutral
室内靠内闪都能出不错的片子	neutral
机身前面红色的可乐标仍然醒目	neutral
不过与相比的机身确实短了一些从左到右方向小黑虽然部分焦段锐度跟不上	negative
因为之前的的画质堪称垃圾主要是高清视频录制清晰度差	negative
人脸识别识别率木有手机或者强四没有防抖	negative
其实和一样	neutral
还有品控问题反光板污点门那感觉和效果是脚底抹油也赶不上	positive
快门大概打了次左右	neutral
优势	neutral
取景器切换时候会有遮挡镜头突出很多	negative
对焦太慢了对焦点的选择也略蛋疼	negative
但渐渐的就习惯了	neutral
就是一台没有电话功能高速卡帮助不大	negative
对于网上经常说的防抖的咔哒声	neutral
但怎么说呢	neutral
快门触感变深对焦速度慢	negative
做工很好	positive
屏幕太破了格式连拍坑爹	negative
一的相机缓存较大	neutral
谈初步感受	neutral
个对焦框太大了	negative
只有从机顶看觉得造型怪异些拍出来的照片色调有些奇怪	negative
年多了也没啥问题	neutral
电池续航能力一般便宜好用的自动镜头少	negative
想想一条钢丝插在快门按钮上晃来晃去	neutral
色彩的话我手持拍摄的出片率较低	negative
软件解决不了	neutral
没有闪光灯	negative
下面全是由出片简单调了颜色后导出	neutral
档有问题艺术效果拍摄时拖尾严重	positive
拍摄后对所得到的图像质量也感到满意	positive
不但可以往上扩展到	neutral
多还多个	neutral
总体感觉很不错	neutral
为了复古	neutral
狡诈	neutral
今年年前	neutral
根本不能对焦	neutral
质量还不如以前的光线暗的时候对焦拉风箱	positive
价格相对昂贵	negative
没有对焦烂也就算了	positive
哈哈	neutral
到底能拍多少张	neutral
对焦真的没什么优势图象完全看不清楚	negative
画质也好	positive
因此背景的虚化不足就一姐夫机的大小	positive
格式连拍坑爹而腾龙出片我个人感觉比较像一个数码记录图像	negative
感受在对焦的时候有些犹豫直接出片机内处理锐度过头了点	negative
最后是对焦速度	neutral
基本无视了	neutral
打到	neutral
比重很多	neutral
宽容度	neutral
俺有象素情结	neutral
没什么用处镜头方面也有不足的地方	negative
和开头的机器甚至开头的机器都不相符的塑料卡口	negative
机身蒙皮磨蚀严重但是像素比较低现在觉得我完全不需要高像素这点下面我会解释	positive
	neutral
上面说的连拍情况是在相机	neutral
感觉都没这样	neutral
操控	neutral
图像很硬只是开电池舱盖和卡舱盖的时候能明显感觉到塑料的做工	negative
画质和操控上	neutral
也有紫边高感就不要太奢求了	negative
这毫无置疑	neutral
照远景效果比许多机子差也不好逃出紫边	positive
虽说不太认同感动家的机身设计不过对大光比的控制方面明显不如全副	positive
中央对焦点很快	positive
确实不够	neutral
当然	neutral
新拍人像的好处之一就是可以做为标准使用	positive
一旦你将机器设定为连拍	neutral
千万象素相机需要好一些的镜头才能发挥水准	neutral
最不满意的也就对焦系统了色彩灰暗	positive
中间你可能干看这一个精彩瞬间错过而干着急	neutral
也可能是我试用的摄友的那个偏旧了而是全新展示机的原因吧	neutral
令人担心划伤	neutral
高感有说不如的对焦精度太差了	positive
在这顺便说一下电池的充电方式和保养	neutral
毫无疑问的	neutral
感觉在变焦的时候有些迟滞目前看感觉照片效果不如上周买的的松下	negative
个人习惯吧	neutral
整体感觉就是一入门机的样子	negative
此外电动变焦镜头挺好玩的	positive
本来是拿洞妖给小五做辅机的	neutral
准不准没咋试	neutral
不如	neutral
顺便入了水的跟	neutral
但只能首张和	neutral
序列号前三位月日出厂	neutral
/仍然是最好的挂机头	neutral
单机左右	neutral
也去一实体店败了一台	neutral
暂时还不够丰富的系统没有确实有点影响出片率	positive
手感操控性能画质已然全面落后没有功能	negative
所见即所得	neutral
缺点	neutral
你总感觉的倍变焦是骗人的窃以为还是的软件功底差了	negative
我找了个二手的的镜头	neutral
成像优秀	positive
的非常差手柄也太小	positive
其实在中	neutral
其出色的性价比受到了广大特别是广大初级摄影爱好者的追捧	positive
但是为什么自动对焦的时候不能用呢	neutral
防抖没有想像中管用可是它的机械性能又实在是不好	negative
按选出网格	neutral
没有官网说的	neutral
已经很好几颗了	neutral
值最高的机身	neutral
这点毋庸置疑	neutral
没有多次曝光功能机械快门线的确蛋疼	positive
很容易能磕出个坑	neutral
所以感觉不错	neutral
成像质量又下降	neutral
你会发现焦点锁定在你选择的物品上移动附带太大不行	neutral
手头只有	neutral
拍的好像蒙了一层雾	negative
很少拉风箱	neutral
光线充足的地方	neutral
送保护贴和包和卡	neutral
首先是对焦大幅提升	neutral
对相机来言	neutral
电池续航能力还不错	positive
入手几天了说说感受	neutral
说明他的电子设计和技术较低端转盘和那个十字大按键有些容易误操作	negative
说着麻烦	neutral
但还可以接受	neutral
似乎码率不够景深预览键没有	positive
真是台强制我不要乱按快门的好机器啊的机身依旧采用工程塑料	positive
而且定价太高了真是台强制我不要乱按快门的好机器啊	positive
个人感觉这个设计非常棒	neutral
价格方面	neutral
免得碍事	neutral
另外	neutral
因为之前的的画质堪称垃圾	negative
传了一张照片到手机	neutral
我之前用的	neutral
你总感觉的倍变焦是骗人的的机身依旧采用工程塑料	negative
没有以往厚重扎实	neutral
快门打到尽然有重影防尘不好	positive
景深表现也不错	positive
对焦迅速准狠	positive
这个设计比较实用	positive
为什么照片这么小对于有人说它是塑料机身	negative
对焦精度太差了对焦行程做得那么长	negative
以前的盒子都和通用	neutral
就说下设计上的不足广角端边缘锐度不行	negative
就是对焦前先来回抽一下让人蛋疼的工业设计到底怎么了	positive
拍了一些照片	neutral
肩屏小了些对焦行程做得那么长	negative
因为经常看到有人说的声音一塌糊涂没有确实有点影响出片率	negative
真头大	neutral
屏幕用这么差的材料电池太渣	negative
转动起来不是很舒服	neutral
这只镜头配合起来就有点问题拍出来的照片色调有些奇怪	positive
也有紫边	negative
出任务的时候	neutral
前部的拨轮则进行了修改	neutral
说明他的电子设计和技术较低端总体上给我的感觉这套系统对焦性能和差不多	negative
其实我不否认	neutral
曾经问过一个搞摄影的朋友一个问题	neutral
这和当初与的选择是一样的	neutral
便宜好用的自动镜头少图象完全看不清楚	positive
重量重不少但在大光圈长焦和闪光灯上还有不足	positive
表现在取景器和想比数据线都不配	negative
就是的色散比重引起的色彩不正及过渡不好	negative
	neutral
不过用起来还真顺手稀饭．	neutral
亮度还是偏低就一姐夫机的大小	negative
先说下有朋友关心的外置	positive
除非深圳的车都排着队超速行驶	neutral
色彩感觉没有原来的容易调整只是属于最严重的一类	positive
买了刚摸了小时简单说下的感受	neutral
档案算蛮小的我是从来不敢使用以上的感光度去拍人像的	negative
机器内闪只有不如做工好	negative
白平衡里面提供了十种白平衡模式自动日光多云阴影等等等等	neutral
这是要比强多了到了以上基本就废了	neutral
快门才释放	neutral
完全没有发挥半透镜优势的对焦张/秒的连拍速度发现对焦速度有所降低	negative
就是内存中如果你拍了视频	neutral
新机持柄变厚变圆	positive
太省钱了	neutral
很好	neutral
曝光不够才跳	neutral
结果借了同学块	neutral
手感比预想的要好	positive
对焦点不行啊就是一台没有电话功能	positive
下次继续作业说	neutral
才感觉很金属	neutral
上架比较靠谱	neutral
与自家的在大小重量上都十分相似	neutral
成像效果还成	positive
效果还不错	positive
色彩太假操作系统反映速度很慢	negative
机身手感一般对焦点不行啊	negative
其次就是机身材质手感专业性外形	neutral
想问问为什么的照片这么小啊	negative
白平衡只能菜单调机身缝隙稍大	negative
对焦速度是目前单电系统软肋液晶屏像素太低	negative
因为我用过的	neutral
首先是那个和啤酒瓶子盖一样的模式转盘手动对焦有	negative
根据我对画质的忍受标准	neutral
另外	neutral
对焦速度是目前单电系统软肋快门延时稍长	negative
忙于学业	neutral
最后想说的是	neutral
且选项专业性较强	neutral
范围由于升至	neutral
多重曝光非常好玩∩∩哈哈	positive
还有可选颜色什么的	neutral
只是控制和手感恐怕没有这么舒服	negative
感觉强的不是一点点	neutral
发现对焦速度有所降低外观变丑了	positive
配置是世界上最低的	neutral
玩了半年就出掉了主要是边缘成像太差色散严重防抖没有想像中管用	positive
最后还是入手了	neutral
都会按照相同的标准提高照片四角的亮度	neutral
格式连拍坑爹	negative
机内软件可能有问题用转接要好很多但又没有了自动对焦	negative
价格也最高只有从机顶看觉得造型怪异些	positive
电池续航能力一般在暗处对焦边缘对焦点无力	negative
白平衡比如确实有一定的进灰问题	positive
因为我本人喜欢机身尽量小一些轻一些的	neutral
只是属于最严重的一类机子太小太轻	negative
操作够复杂的防抖没有想像中管用	positive
偶尔也会拉风箱	neutral
我觉得的机身手感很不理想操作系统反映速度很慢	positive
液晶屏像素太低一是太小完全不像是消费专业级数码相机的水平	positive
液晶屏像素太低操作系统反映速度很慢	negative
所以我也来说说作为一个爱好者的一些看法	neutral
快速操作的时候减少误操作	neutral
但可以塞进大衣的口袋加载薯片或者塞进摄影马甲口袋	neutral
画面颗粒感较强最大的问题是为小体积而小体积	negative
按键按起来啪啪响色彩的话	negative
我认为就是一个摆设	neutral
有时在长焦段会有拉风箱现象价格贵不少	positive
刚上手觉得操作特别困难但是长焦是外变焦	negative
说明他的电子设计和技术较低端松下出来的图片的比对度的确有点不够	negative
附带的解软件解出来的效果非常差我是从来不敢使用以上的感光度去拍人像的	negative
我是从来不敢使用以上的感光度去拍人像的	negative
数码单反有一个系数问题	neutral
闪光灯没有闪光灯的噪点属于比较大色斑	negative
另外	neutral
当然主要还是因为人犯懒了	neutral
压缩比有些点对焦速度一般	positive
试过边缘对焦结果对焦和色彩让人失望	negative
似乎码率不够底感差	positive
操作的时候小里小气的表现在取景器和想比	negative
套头成像颜色偏冷转盘和那个十字大按键有些容易误操作	negative
存储速度慢导致无法进行连续拍摄	negative
光圈下	neutral
做工一般就说下设计上的不足	positive
有时候界面操作都会有些许延时现象外盖分成了三部分	positive
也就忍了	neutral
首先我买不起变焦	neutral
暂时还不够丰富的系统但我宁可这样也不要糟糕的做工	negative
主要是高清视频录制清晰度差暗部对焦拉风箱	positive
的工业设计到底怎么了没什么用处	positive
用的时候快门声音很怪价格相对昂贵	negative
我个人觉得	neutral
可以用永诺	neutral
的对比对焦显然没有的相位对焦快顺便吐槽这几个新出的镜头	negative
的外观经过少许改变	neutral
改成了位于下部的按键	neutral
重量重不少对焦精度太差了	negative
功能很好玩	positive
重量对来说也还可以接受	neutral
没有感受在对焦的时候有些犹豫	negative
但我却很喜欢真实的色彩寸万象素的液晶屏有点落伍了	negative
仔细观察发现其实主要是噪点的表形式不一样	neutral
一镜走天下	neutral
原先用	neutral
色彩不偏差就是一台没有电话功能	positive
就是格式照片有点偏大本人用寸笔记本有时在长焦段会有拉风箱现象	positive
有点呆板	neutral
但是操作也大同小异了	neutral
应该是吧	neutral
画质没有什么出彩的地方奥巴的/镜头也是个大块头	positive
当然从官方的介绍	neutral
可能是和机身不匹配	neutral
因为我一直认为数码产品各司其职	neutral
这点全挤在中间啊	neutral
但是	neutral
默认锐度和色彩鲜度都一般	neutral
这个	neutral
雾蒙蒙的	neutral
是电池够玩	positive
和真人的肤色相识度	neutral
对于已经有	neutral
我还是觉得轻便比较靠谱	neutral
机身质量比我想象中的好得多	positive
说明除尘效果的确有用	neutral
对失望后	neutral
具有程序自动曝光全自动闪光灯禁用创意自动人像风光微距运动夜景人像程序快门优先自动曝光光圈优先自动曝光手动曝光门曝光多种模式	neutral
要么找错焦点	neutral
不过对大光比的控制方面明显不如全副	negative
功能不如但在大光圈长焦和闪光灯上还有不足	negative
我用的是	neutral
多拍些好照片和大家分享谢谢	neutral
出乎意料的喜悦持续了很久	neutral
的样子见仁见智了	neutral
机身缝隙稍大机背液晶屏竟然是塑料的	negative
本家镜头除了头都比较清淡	neutral
比不了饼干	neutral
无语死了	neutral
增强了手感	positive
大概有光线调整功能	positive
机身的握感上	neutral
就一姐夫机的大小	negative
感觉开关拧到距离过长结果对焦和色彩让人失望	negative
为什么照片这么小最大的问题是为小体积而小体积	negative
夜景画质很一般	negative
另外在输出的时候	neutral
但我发现	neutral
个月时间	neutral
的对焦屏比较简单的感觉但对色彩的处理还不如众老厂经验丰富	positive
这些都没什么可说的	neutral
的手感应该比较好	positive
外盖分成了三部分	negative
机械快门线的确蛋疼对强光源的处理不好	negative
在机器保持横着放置的时候回放	neutral
这个比较遗憾	neutral
小黑虽然部分焦段锐度跟不上此头焦外绿边十分严重	positive
对焦点有点集中窃以为还是的软件功底差了	negative
肤色偏金黄色景深预览键没有	negative
的噪点属于比较大色斑只是属于最严重的一类	negative
先说说像素吧	neutral
真不知的设计师是怎么想的	neutral
希望有公司的人路过	neutral
自己看吧	neutral
的机顶液晶屏更大	positive
细节也不错	positive
但是一个重大缺陷	neutral
就是不懂为什么一个用屏幕做取景器的机器	neutral
因为经常看到有人说的声音一塌糊涂但我却很喜欢真实的色彩	positive
应该很强大	neutral
结实耐用在数码时代已经不那么重要了	neutral
主观上觉得快门时滞变长了但实际没有变	neutral
很多人觉得造型很怪异玩了半年就出掉了主要是边缘成像太差色散严重	negative
电池不够用肤色偏金黄色	positive
不知有没有人有我这样的感觉	neutral
变成了与相同的万像素	neutral
还有电子水平仪	neutral
分辨率也高	positive
最先淘汰的是和系列	neutral
画质还不错	positive
手感操控性能画质已然全面落后不满的是反映速度	negative
可能握持上不是太舒服像素密度太密了	negative
顺便讲一个曾经蛋疼的事	neutral
系统吸引了副厂的大量兴趣比如说和转接环	neutral
对焦速度偏慢反差较小时镜头还会拉风箱	negative
目测对焦速度慢于结果对焦和色彩让人失望	negative
景深预览键没有这个头的对焦性能并不好	positive
亮度还是偏低数据线都不配	negative
峰值对焦的这个功能我特别喜欢	positive
细节较多	negative
为什么那么多人钟爱或者说追捧那	neutral
还有品控问题反光板污点门除了价格比较高一些	negative
给大家简单介紹一下的主要改进特色	neutral
色彩迷人	positive
应该说我对这个机器非常了解	neutral
这段时间只试过一次对不上焦	neutral
除了多带几块电池之外	neutral
景深预览键没有	negative
奥巴的机器握感都不好暗部对焦拉风箱	negative
感受不好把握	neutral
不过也许这些也与我对该相机的使用不太熟悉有关	neutral
塑料感强手动对焦有	positive
说真的这款机在单反群体里并不贵	neutral
点对焦寸与千万象素的普及	neutral
机子太小太轻这是镜头太水的原因	positive
有出现过拉风箱的现象	neutral
肩屏小了些玩了半年就出掉了主要是边缘成像太差色散严重	positive
但还是不太有信心	neutral
外观既没有时尚这么密的小像素	negative
操作手感不如	positive
入之前也有点小担心	neutral
好了	neutral
目前单机	neutral
进灰门	neutral
还希望论坛里的朋友多把目光转向技术层面	neutral
也是如此的设计就感觉出来的片子更糟	negative
首先先发点感慨．．．好机．真的是好机．．．	neutral
最终我买了	neutral
首先是微单	neutral
但拿在手里稍轻	neutral
快门打到尽然有重影	negative
致命的阳光下看不清屏幕	negative
是走简化的路子	neutral
所以手感上面也比较不错	positive
再说	neutral
表示耳朵没有这么好	neutral
当你厌倦了大光圈虚化的世俗效果时	neutral
相比较	neutral
优点	neutral
不过的快门声音做的很好听	positive
稍逊于单反的机械性能表现在取景器和想比	positive
没有内闪暗部对焦拉风箱	negative
使用较重镜头的时候	neutral
目前价位还是高于的窃以为还是的软件功底差了	positive
真的算一台很据性价比的实惠的大长焦好机子	positive
而远角端只有对焦速度慢	negative
我感觉和大致相同	neutral
高速连怕只能用在上	neutral
好多直出可用	positive
我的观点还是的事就交给相机自己处理吧	neutral
就拍不出来	neutral
先对焦后构图速度太慢且容易焦点偏移就是不太方便	negative
对焦倒是利索的很	positive
但是阳光下的远景分辨率说句不好听的就像手机拍的一样而且紫边也不小操控缩水	negative
对对焦点的明暗反差要求比较高机身轻小后的缺陷装个都觉得头重脚轻	negative
感觉比要好	positive
对焦速度是目前单电系统软肋表现在取景器和想比	positive
入门机器么	neutral
体积太大我的就是最小的暗部噪点也清晰可见	positive
视角变化	neutral
并且较为便携的选择	neutral
杂拍说说新入手的感受	neutral
使用半年	neutral
尤其是曝光锁定键只是控制和手感恐怕没有这么舒服	negative
也没专业也有紫边	positive
而且的用户群越来越小白化	neutral
不过	neutral
就是快门声音不怎么样它相机里电池自行放电由来已久	negative
它的光圈要通过在镜头上的光圈环来调整	neutral
够你练手用了	neutral
要是左右就完美了	neutral
那是一个特殊的算法	neutral
对焦确认功能的确非常好用	positive
年中单位器材换新	neutral
新机没有如我期待的那样表现	neutral
又配了块品胜	neutral
以上那些感受仅供参考	neutral
对焦点有点集中附带的解软件解出来的效果非常差	positive
我是从来不敢使用以上的感光度去拍人像的在暗处对焦边缘对焦点无力	negative
开始时是灰的	neutral
镜头确实比较强	positive
我的观点是高像素不能说不重要	neutral
可能与镜头口径比较大有关吧在中算比较大了	neutral
其实松下除了画质外所以设计理念上不高明	positive
手感操控性能画质已然全面落后白平衡只能菜单调	negative
接下来的几年里	neutral
虽然说不上拉风箱	neutral
机械快门线的确蛋疼洞妖的明显要慢于的	positive
当然也更方便了自拍	neutral
参数平平	neutral
说说使用感受	neutral
体积有所减小	neutral
对焦模式也丰富很多	positive
没有闪光灯肩屏小了些	positive
有点小	neutral
不满的是反映速度如果能有对焦微调	negative
配合随机带的转换热靴可以和我的灯兼容	neutral
显示屏远远好过小五的	positive
和的比似乎就少了点相位对焦点的对焦	negative
中央五个对焦点很暴力自动对焦较慢	negative
但是以上就有部份杂讯	neutral
细节较多有时在长焦段会有拉风箱现象	negative
附带的解软件解出来的效果非常差	negative
机背采用的布局	neutral
快门声很小	neutral
我发现的色彩非常干	negative
不允许拿下来	neutral
只是控制和手感恐怕没有这么舒服肤色偏金黄色	positive
感受现在强大的手机照相摄像功能	neutral
那个人的肤色偏黄的	neutral
个人觉得做工不如对焦框不会显示	positive
当然	neutral
的我一会不敢超过对对焦点的明暗反差要求比较高	negative
操作的时候小里小气的手柄突出部分和镜头对焦环之间的空间挤了点	negative
而如果欠曝	neutral
没有对焦慢	positive
如果能有对焦微调但在自动对焦操控感受上还存在一定差距	negative
的确的背景虚化不太好做/的快门大家都非常郁闷	positive
折算之后大概是更适合户外的拍摄	neutral
如果能忍受它缓慢的存储速度的话发现对焦速度有所降低	negative
在不回放	neutral
机宽容度很好	positive
还是铁手重要	neutral
而且使用速度狂慢我用的是苹果一体机的对焦屏比较简单的感觉	negative
还有什么方法拯救这个缺点	neutral
则不同	neutral
但驱动有点慢夜景画质很一般	negative
如果不是放大照片	neutral
几个小按钮的感觉也是如此说明他的电子设计和技术较低端	negative
外接闪光灯真丑比如白平衡没有显示	negative
功能不如全副镜头在上广角损失严重	positive
因为光圈排线坏掉送修两次	neutral
而自从出了竹炮以后	neutral
特别是电池舱盖白平衡	negative
动动脑子想一下	neutral
室内人像偏黄偏绿	neutral
液晶屏像素太低	negative
如果不出这个系统	neutral
作为新手其实也够了也拍了不少好片子	neutral
注意行程比较短	neutral
我最不满意的是那个删除键对焦速度慢这个完全不能和单反比啊	positive
景深预览键没有但实际试用发现对焦迟滞太严重	positive
不是手工按压收回去	neutral
有时候界面操作都会有些许延时现象夜景画质很一般	negative
图象完全看不清楚但驱动有点慢	negative
镜头方面也有不足的地方但是阳光下的远景分辨率说句不好听的就像手机拍的一样而且紫边也不小	negative
重量重不少但因为绿屏问题实在让我觉得膈应	negative
但是感觉跟还是有一定差距的白平衡	negative
囧	neutral
但是外挂电源毕竟影会影响的便携性艺术效果拍摄时拖尾严重	positive
对焦烂也就算了而且很象没有录像	positive
以前很多人都说的机身差看着取景器里的对焦点从模糊清晰模糊清晰的过程的确有砸机冲动	positive
手感	neutral
但对色彩的处理还不如众老厂经验丰富	negative
给同好做个参考吧	neutral
广角端边缘锐度不行长焦端没有防震	negative
连拍最快连拍是张每秒	neutral
还是啥点测光	neutral
它相机里电池自行放电由来已久我发现的色彩非常干	positive
去年年底入手	neutral
多年以后我一直记着这个桥段	neutral
其芯片是单个像素最大的	neutral
闪光灯没有闪光灯想问问为什么的照片这么小啊	positive
广角的搭配很好	neutral
做为手持设备	neutral
至今仍然不输于一般数码的拍摄画面质素	positive
比如确实有一定的进灰问题它相机里电池自行放电由来已久	negative
只不过应该会耗费不少电力吧我手持拍摄的出片率较低	negative
没有考虑到不同镜头有不同程度的暗角的情况	neutral
充电感觉不是很方便另外高感也差很多	positive
唯一办法是多带几个电池	neutral
相机的操控性能	neutral
现在的屏幕裸露在外没有	negative
不过相机还是用来拍片	neutral
并非一无是处	neutral
想直接放衣兜里	neutral
只是控制和手感恐怕没有这么舒服对焦点不行啊	negative
我需要拍那种	neutral
说来惭愧	neutral
塑料感强且目前售价也略高	positive
我可以说是超值	neutral
寸万象素的液晶屏有点落伍了	negative
但在大光圈长焦和闪光灯上还有不足顺便吐槽这几个新出的镜头	negative
机器内闪只有外盖分成了三部分	negative
脚架环拆装很方便	positive
价格对我来说也贵了	negative
软件不太好使同样用测试对焦	negative
去试了下	neutral
这样增加了握持手感	neutral
还算习惯	neutral
谁同时用过与	neutral
对强光源的处理不好液晶屏像素太低	positive
还是人家送的卡	neutral
以前很多人都说的机身差有时候界面操作都会有些许延时现象	negative
毕竟这个价格超过一台入门单反了	neutral
另外高感也差很多带来的问题就是握持感	negative
有哪里不好请多多指导	neutral
这意味着你可以放心地使用大光圈来拍摄而无需担心跑焦问题	neutral
暗部对焦拉风箱现在多出来的锁定键做的太	positive
对焦行程做得那么长对对焦点的明暗反差要求比较高	positive
个人感觉总体还是倾向于	neutral
就是格式照片有点偏大本人用寸笔记本机身塑料感十足	negative
估计接近公分	neutral
快门延时稍长在肩屏的信息显示量上也不够丰富	negative
没有充电感觉不是很方便	negative
应该就是进这台	neutral
快门声音真心不好听让那些用的女士双臂平伸端着手感很差的克重物显得那么滑稽可笑	negative
达到了画幅清晰度的顶峰	neutral
目测对焦速度慢于真的就是系统慢了点	negative
不过通过在的试机体会	neutral
奥巴的机器握感都不好亮度还是偏低	negative
机背液晶屏竟然是塑料的按键按起来啪啪响	positive
自动白平衡的确有改善	positive
放大倍率倍	neutral
下面是几张高感的照片	neutral
比的	neutral
单反数码机	neutral
操控上	neutral
尽管还没搞定操作细节	neutral
使用习惯的不同	neutral
国行的既没有功能	neutral
对焦速度慢这个完全不能和单反比啊对焦太慢了	positive
就是色彩比较淡快门延时稍长	positive
:还是的操控好	positive
以对焦操控见长	positive
过年用了一段时间	neutral
取景器切换时候会有遮挡外接闪光灯真丑	positive
动态照片用快门优先	neutral
的手感虽然少了的厚重感	negative
大概关注了这台相机有一个多月了	neutral
套头成像颜色偏冷但在大光圈长焦和闪光灯上还有不足	positive
在强光下太不清楚	neutral
初步谈谈体会	neutral
而且因为光学取景器的提升	positive
总体上给我的感觉这套系统对焦性能和差不多不过手感一般	negative
无奈天津地区一直没货	neutral
但是的操控感觉甚至要胜过的	positive
只配了个镜头银广角	neutral
轻微的触碰这个盖很容量掉下来	neutral
自动白平衡更准确	positive
晚上用来拍远处的一栋高楼	neutral
可是它的机械性能又实在是不好但是阳光下的远景分辨率说句不好听的就像手机拍的一样而且紫边也不小	negative
闪光灯没有闪光灯这景深伤不起	positive
到现在已经不止一周了	neutral
呵呵	neutral
下单几天后相机就送到了手中	neutral
只是属于最严重的一类暂时还不够丰富的系统	negative
存取慢就是一台没有电话功能	negative
多钻研这一机两头	neutral
怎么设置啊	neutral
但是强劲的机能会弥补画质的不足就是不太方便	negative
不过完全在可以接受的范围内	neutral
怎么取景怎么拍照突然都不会了	neutral
的噪点属于比较大色斑我发现的色彩非常干	negative
但体积不小数据线都不配	positive
在正常的光照度下一般需要秒的时间对好焦	neutral
上图有点儿麻烦啊	neutral
是不是机子和镜头有问题啊	neutral
但对色彩的处理还不如众老厂经验丰富色彩不正及过渡不好	positive
结果对焦和色彩让人失望体积太大	negative
电池续航能力一般比偏红偏假的色彩	positive
后来打到档	neutral
上个的正面照	neutral
直出太差了对焦太慢了	positive
防抖没有想像中管用如果能有对焦微调	negative
我上手的是特别快	neutral
有时候居然可用	neutral
不能变焦只好多跑几步	neutral
均为手持	neutral
点评	neutral
最不满意的也就对焦系统了操作的时候小里小气的	positive
风景摄影表现一般无摄像功能	negative
宾得单电使用感受	neutral
您看的时候注意相机数据	neutral
真的就是系统慢了点感觉看不出噪点	positive
关于材质和手感	neutral
我在星际城市三楼的买的	neutral
而腾龙出片我个人感觉比较像一个数码记录图像就是成像似乎不像是微单的水平	negative
其对焦范围几乎包含了屏幕的区域	neutral
对焦速度一般发现对焦速度有所降低	negative
用的时候快门声音很怪	negative
似乎码率不够自动白平衡在某些特定场合容易出錯	negative
其他象手感操控啊	positive
但是后来觉得操控上和手感上会威武很多	positive
但拍出照片的却常常显示或	neutral
很多人觉得造型很怪异套头成像颜色偏冷	negative
为什么这么耗电	neutral
感觉速度不错	positive
而且定价太高了比偏红偏假的色彩	negative
定室内耍的开了	neutral
这种解决方案远比和必须在热靴上安装一个另购的遥控接收器	neutral
并且支持卡存储了	positive
的手感虽然少了的厚重感电池使用寿命短不过该机器已经设计了外接电源的线孔	positive
缺点是体积略大	negative
但是在的情况表现依旧那么给力	neutral
在洞妖上完全被洗刷	neutral
大的要死	neutral
光圈值会显示在取景器内	neutral
快门声音真心不好听真的就是系统慢了点	negative
但这没有影响到我的激情	neutral
在进行剪裁时就能充分显示高像素的优越性了	neutral
也马马虎虎可以接受	neutral
我觉得还是由于的对焦速度太慢导致的	neutral
新一代暗处色彩丢失可能是因为噪音太大导致严重降噪抹除了颜色体积小	negative
在菜单中的部分项目	neutral
比差一个档次	neutral
最后下决心购买还是因为看了这日本人的博客	neutral
我手比较大	neutral
有人说也挺好啊其实关键有个	neutral
目前的触摸屏除了用于菜单以外	neutral
想问问为什么的照片这么小啊配长焦机身偏小	negative
对焦精度会有所下降	neutral
的电子技术确实不高不深先对焦后构图速度太慢且容易焦点偏移	negative
进行手动对焦	neutral
在现场也用自己的机器拍了相同场景	neutral
二功能相当的多	positive
本人年多的用户	neutral
配长焦机身偏小没有	positive
和的高感成像质量相比较而言就有些惨了高感就不要太奢求了	negative
的快门声音是根据专业摄影师的反馈进行调教的	neutral
即是	neutral
加上屏和的因素	neutral
刚玩了一会	neutral
做工一般还有品控问题反光板污点门	negative
画质么应该是没的说	positive
但是长焦是外变焦手感操控性能画质已然全面落后	negative
已经足够	neutral
在光线好的时候表现非常强	positive
配置一般目前还没有配的既小巧又足够强大的闪光灯	negative
操作系统反映速度很慢而且很象没有录像	positive
而不再是金属机身了	neutral
终于可以爽一下了	neutral
别的没用过	neutral
机器内闪只有价格贵不少	negative
谈谈初步的感受	neutral
小蓝标亮瞎一片	neutral
光学取景器聊胜于无不过对大光比的控制方面明显不如全副	positive
对焦慢	negative
这就意味着	neutral
现在手头有的是	neutral
就不谈了	neutral
可以当它是单反了	neutral
但是总的来看	neutral
拍普通人像的	neutral
除了楼下资深说的要为镜头纠结	neutral
并终于从德国淘得老机	neutral
也拍了不少片子	neutral
比如说	neutral
另外提一句	neutral
片子发暗种种现象玩了半年就出掉了主要是边缘成像太差色散严重	negative
幅机身的画质表现画面的致密程度色深曝光宽容度和全幅底的相机毕竟还是有明显的差距	neutral
所以设计理念上不高明	negative
那个镜头体积跟机身较合适	neutral
其余的对焦点尤其是曝光锁定键	negative
怕对焦不实	neutral
哎很尴尬	neutral
但是感觉跟还是有一定差距的色彩感觉没有原来的容易调整	positive
感觉手柄还是略小直出太差了	positive
手感操控性能画质已然全面落后就是不太方便	negative
而且主要集中在取景器的中央位置	neutral
"最特別的也是笔者最感兴趣的地方還是在于"":万像素可外翻使用的"	positive
又重新拿到了	neutral
但因为绿屏问题实在让我觉得膈应和的高感成像质量相比较而言就有些惨了	negative
看看	neutral
昨天买了黑卡	neutral
手动对焦更慢一些屏幕太破了	negative
画质偏软但是强劲的机能会弥补画质的不足	negative
变焦感觉有点慢哦窃以为还是的软件功底差了	negative
比如	neutral
不懂乱说大家口下留情	neutral
从缩图来看	neutral
带出去也不敢敞开用当然不是人人和我一样	neutral
一定会让你体会到用心拍照的乐趣	neutral
感觉手柄还是略小现在多出来的锁定键做的太	negative
不过手感一般套头成像颜色偏冷	negative
但今年由于工作变动	neutral
紫边也是它引起的	neutral
很担心容易坏	neutral
首先是那个和啤酒瓶子盖一样的模式转盘没有	negative
很有操控感	neutral
合焦比较坚决和迅速	positive
整体感觉就是一入门机的样子对焦速度偏慢	negative
奇怪	neutral
对于拍摄人物特写	neutral
其实操作起来很容易	neutral
期间不能按快门	neutral
就连续打机关枪	neutral
性价比上佳的机器	positive
我喜欢的地方	neutral
稳定性照电子快门线和遥控器差的多艺术效果拍摄时拖尾严重	positive
甚至可以说很差	neutral
对强光源的处理不好感觉开关拧到距离过长	positive
让手动对焦轻而易举	neutral
反差较小时镜头还会拉风箱手感操控性能画质已然全面落后	negative
色彩冷	positive
长焦端没有防震	negative
想着拍照	neutral
相对简化了	neutral
希望大家小心一些	neutral
取景器	neutral
左上角的拨盘看上去仍然很幼稚色彩的话	negative
比出色	positive
奥巴的机器握感都不好操作系统反映速度很慢	positive
长焦端没有防震价格相对昂贵	negative
不过自拍应该够	neutral
就是一台没有电话功能的对焦屏比较简单的感觉	positive
洞妖的是格式的	neutral
你总感觉的倍变焦是骗人的艺术效果拍摄时拖尾严重	negative
也有网文评测中高端单反	neutral
这是镜头太水的原因但体积不小	negative
试过边缘对焦感受在对焦的时候有些犹豫	positive
足够满足一般用户	neutral
但实际试用发现对焦迟滞太严重快门触感变深	positive
而且在重量上也更让人感觉舒适	positive
重量还好	neutral
分享给大家	neutral
没有防水防尘如果能忍受它缓慢的存储速度的话	negative
依然很干净	neutral
机内测光容易出错导致过曝我的就是最小的暗部噪点也清晰可见	negative
对于一万元步入单反这个大门的朋友	neutral
很暗的地方都能轻松拍出来	neutral
配长焦机身偏小机内软件可能有问题	negative
色彩偏暖	positive
只是在调节上多做一些	neutral
全画幅	neutral
电池续航	neutral
也没专业色彩感觉没有原来的容易调整	positive
对焦点有点集中	negative
好在现在类似的转换插头也多了	neutral
所以	neutral
还有品控问题反光板污点门	negative
盖上没有办法盖在镜上	neutral
如果能有对焦微调	negative
这只镜头配合起来就有点问题	negative
密封不好等	negative
小五就成打酱油的肩屏小了些	negative
体积小和的比似乎就少了点相位对焦点	positive
采用单反卡口	neutral
总体上给我的感觉这套系统对焦性能和差不多	negative
当屏幕的亮度调节到中间的时候	neutral
自己买了;松下买了	neutral
新一代暗处色彩丢失可能是因为噪音太大导致严重降噪抹除了颜色只是开电池舱盖和卡舱盖的时候能明显感觉到塑料的做工	negative
从机器本身到所有配件	neutral
感觉在变焦的时候有些迟滞格式连拍坑爹	negative
手动对焦的时候可以直接放大对焦点微调确认	neutral
锐度偏低的机身依旧采用工程塑料	negative
先说一下我认为的缺点	neutral
相较于家族前几代的全画幅单反相机	neutral
密封不好等肤色偏黄	positive
发出来的是一种沉闷声	neutral
总体来说倾向于	neutral
我原有和两台单反	neutral
不足部分	neutral
由于是可翻转设计	neutral
体积小风景摄影表现一般	negative
只是控制和手感恐怕没有这么舒服	negative
那一天快到了	neutral
机身缝隙稍大想问问为什么的照片这么小啊	negative
下图基本上只用了原片的/强	neutral
感觉是算法的原因	neutral
虚化好	positive
联通合约机	neutral
快门声音比我想象的大得多先对焦后构图速度太慢且容易焦点偏移	negative
昨天摸了真机	neutral
电池使用寿命短不过该机器已经设计了外接电源的线孔有时在长焦段会有拉风箱现象	negative
感受如下	neutral
万	neutral
只有从机顶看觉得造型怪异些表现在取景器和想比	positive
在用这个机器之前	neutral
很蛋疼	neutral
但在基本的锐利度表现不满的是反映速度	positive
首先是对焦	neutral
每拍一张到再次能拍摄	neutral
但实际外观也很小巧	positive
试过边缘对焦数据线都不配	positive
的感光度在的时候也只能说勉强凑合看	negative
对焦速度尚可	positive
存在物理误差是难免	neutral
录像也还可以	positive
档案算蛮小的的对焦屏比较简单的感觉	positive
目前还没有配的既小巧又足够强大的闪光灯细节较多	positive
谈点感受	neutral
程度不够	neutral
	neutral
这个时候看下帮助页面可以解决很多问题	neutral
的确差很多	neutral
直接免疫了跑焦这回事情	neutral
但是像素比较低现在觉得我完全不需要高像素这点下面我会解释目前看感觉照片效果不如上周买的的松下	negative
但便携机在图像质量上总是稍欠缺一点还有不能换镜头局限了拍摄题材中央五个对焦点很暴力	positive
这里要说说这三个镜头里面我最最不常用的一个	neutral
就是的色散比重引起的	negative
没有防水防尘体积小	negative
因此背景的虚化不足但是感觉跟还是有一定差距的	negative
长焦端没有防震就是一台没有电话功能	negative
以美金上下的价格	neutral
不用	neutral
金属机身皮革覆盖范围也广	positive
所以让人感觉塑料感稍重片子发暗种种现象	negative
到洞妖上	neutral
大家千万别以为我买是为了给它挑毛病	neutral
连拍超过张后就开始卡机变成约三张每秒的慢速连拍	neutral
主要是高清视频录制清晰度差但因为绿屏问题实在让我觉得膈应	positive
但在自动对焦操控感受上还存在一定差距夜景画质很一般	negative
如果当时能够有人指导我一下如何去看待单反	neutral
快门声音比我想象的大得多格式连拍坑爹	positive
而是带有一点回馈力度	neutral
镜头自动对焦	positive
各种的拨盘选择器在调整参数上确实很便捷	positive
此头焦外绿边十分严重除了价格比较高一些	positive
防抖没有想像中管用但是长焦是外变焦	negative
接图的效果也不如	negative
会稍强些	neutral
所以只是关注	neutral
宾得的传统	neutral
昨天入咯	neutral
和虽然都是双卡槽	neutral
宾得有前途了	neutral
也初步了解了两台机器的性能	neutral
就是快门声音不怎么样但是屏幕实在不堪入目	negative
就是对焦前先来回抽一下让人蛋疼洞妖的明显要慢于的	positive
就算你看惯了万象素的屏	neutral
觉得电池续航能力很一般没有多次曝光功能	positive
找到人脸是五五开	neutral
总的来说用来拍人像肤色怪怪的和开头的机器甚至开头的机器都不相符的塑料卡口	negative
就一姐夫机的大小的遮光罩为什么总是做的很松	negative
增加了相位对焦取景器闪光灯接口	positive
按住快门时	neutral
即使能使用也需要加一个多功能手柄	neutral
高感时:和成像质量明显优于和	positive
体积小	negative
但我只能告诉你	neutral
基本可以还原物体质感	neutral
难道大鼻子就这么有号召力	neutral
真是台强制我不要乱按快门的好机器啊	negative
就是紫边太严重机械快门线的确蛋疼	negative
但在大光圈长焦和闪光灯上还有不足的工业设计真是倒退了三十年	negative
我的就是最小的暗部噪点也清晰可见	negative
底感差外接闪光灯真丑	negative
感觉没什么可换啊	neutral
画质高感不敢武断评论	neutral
主要是因为色散控制不好的原因但是外挂电源毕竟影会影响的便携性	positive
一个是	neutral
本人使用了东芝卡	neutral
效果很出乎我的意料	positive
拿到手上第一感觉是并没有我想象的那么重	neutral
高感时:和成像质量明显优于和	positive
浪费了很多精力在器材上	neutral
所以	neutral
对焦的速度上并不是很突出	negative
还有就是确实存在严重的屏偏绿的问题对对焦点的明暗反差要求比较高	negative
画质确实比小五提升了	positive
这个头的对焦性能并不好压缩比有些点	negative
也是一大致命伤	neutral
因为经常看到有人说的声音一塌糊涂目前看感觉照片效果不如上周买的的松下	positive
其他的型号也用过	neutral
百分百查看	neutral
直出太差了因此背景的虚化不足	negative
我去肯尼来几天	neutral
由于和宾得和有协议所以少了	neutral
正好抚摸之	neutral
现在想想	neutral
翻转屏	neutral
因为的电池也是延续上一代的	neutral
防尘不好自动白平衡在某些特定场合容易出錯	positive
就是快门声音不怎么样奥巴的/镜头也是个大块头	positive
省了几个月饭钱	neutral
当我看到兔子的出片	neutral
轻便老婆拿到手机玩了一会儿才想起问我	neutral
如果可以自动对焦后再放大再全时手动微调那就爽了	neutral
光线暗的时候对焦拉风箱密封不好等	negative
不知道是我利害还是它的防抖功能够劲	neutral
但便携机在图像质量上总是稍欠缺一点还有不能换镜头局限了拍摄题材	negative
曝光补偿单独拨轮很实用	positive
争取每天把影友对这个意见顶起来	neutral
对焦框不会显示	negative
不管你使用哪种	neutral
真的感觉的技术很强大	positive
至少省元	neutral
套头成像颜色偏冷现在多出来的锁定键做的太	positive
白平衡价格也最高	negative
但是像素比较低现在觉得我完全不需要高像素这点下面我会解释对焦点的选择也略蛋疼	negative
它相机里电池自行放电由来已久但在大光圈长焦和闪光灯上还有不足	positive
我也没看到这类塑料机挂然后相机碎了这类事情	neutral
刚看觉得丑的要死	neutral
档案算蛮小的没有确实有点影响出片率	negative
虽然木有像那样完全取消低通	neutral
谈谈感受	neutral
顺便吐槽这几个新出的镜头	negative
三对焦	neutral
太阳下拍人像非常有优势	positive
简单谈一下初步感受	neutral
寸万象素的液晶屏有点落伍了其余的对焦点	positive
的镜头也是一样	neutral
景深预览键没有带来的问题就是握持感	positive
奥巴的机器握感都不好但是像素比较低现在觉得我完全不需要高像素这点下面我会解释	positive
另外还多了一个叫做静音快门吧	positive
广角很爽	positive
显得不好看	neutral
外接闪光灯真丑机身蒙皮磨蚀严重	negative
不得不称赞一下的屏幕色彩	positive
对焦的速度上并不是很突出似乎码率不够	positive
改换了	neutral
以下随便使用	neutral
微距自动对焦较慢不过手感一般	positive
非常强烈的建议	neutral
对焦变得很爽了	positive
从我个人体会来说	neutral
去玩机了．	neutral
因为经常看到有人说的声音一塌糊涂白平衡只能菜单调	negative
直出太差了的工业设计真是倒退了三十年	positive
画质没有什么出彩的地方但是像素比较低现在觉得我完全不需要高像素这点下面我会解释	negative
的我一会不敢超过机身轻小后的缺陷装个都觉得头重脚轻	negative
或以上了	neutral
还算靠谱	neutral
嘛	neutral
只是属于最严重的一类用过/系统的人绝对会受不了的触摸屏	positive
色彩不够鲜艳不过与相比的机身确实短了一些从左到右方向	positive
说明他的电子设计和技术较低端电子取景器有时滞	negative
由于使用了全新的对焦模块	positive
完全不是口袋型的	neutral
便宜好用的自动镜头少机身蒙皮磨蚀严重	positive
成为新一代街机	neutral
但因为绿屏问题实在让我觉得膈应直接出片机内处理锐度过头了点	negative
从以往实际使用看	neutral
不敢带出去	neutral
机身很大	positive
我手持拍摄的出片率较低对焦的确非常非常慢	negative
让你根据需要配备	neutral
因为这一块毕竟不是技术问题了	neutral
其实用过此类机子的都应该知道	neutral
快门声音比我想象的大得多感觉机身的自动白平衡有点问题	positive
同样快门速度夜景手持真的很吃力	negative
掉点漆无所谓	neutral
觉得电池续航能力很一般防抖没有想像中管用	positive
连续的	neutral
对焦速度还稍微跟不上	negative
很多人全副	neutral
它拥有和是相同的的感光元件	neutral
反应速度比有较大提高	positive
毕竟这个价格的倍长焦也就柯达一家了	neutral
另外高感也差很多我发现的色彩非常干	negative
因为之前的的画质堪称垃圾但体积不小	positive
四没有防抖对强光源的处理不好	positive
随意试机	neutral
没什么用处新一代暗处色彩丢失可能是因为噪音太大导致严重降噪抹除了颜色	positive
四连拍	neutral
价格相对昂贵机身塑料感十足	negative
连续拍摄没问题	neutral
自然也沿用了系列大型眼罩	neutral
过曝的话	neutral
又引起了兴趣	neutral
也不好逃出紫边	negative
但是感觉跟还是有一定差距的存取慢	negative
关于	neutral
为什么照片这么小当然这也许是白平衡的问题	negative
看别人又拍的人像	positive
对焦精度太差了目前看感觉照片效果不如上周买的的松下	positive
可是它的机械性能又实在是不好出来的片子更糟	positive
真的就是系统慢了点屏幕用这么差的材料	positive
视窗真大真清晰啊	positive
有时候界面操作都会有些许延时现象档案算蛮小的	negative
最大的问题是为小体积而小体积看着取景器里的对焦点从模糊清晰模糊清晰的过程的确有砸机冲动	negative
但更高的分辨率也使得被摄对象脸部的缺点随之放大	neutral
我所在的城市和其他的大城市不能比啊．．．	neutral
我手可能也比较大吧	neutral
试过边缘对焦主要是高清视频录制清晰度差	positive
结果对焦和色彩让人失望对焦行程做得那么长	negative
而且高感的效果并没有下降	positive
接下来谈一下感受哈	neutral
反正我也从来不用	neutral
电池还行吧	positive
是否可以增大些呢	neutral
对焦烂也就算了奥巴的机器握感都不好	negative
我是从来不敢使用以上的感光度去拍人像的夜景画质很一般	negative
也是如此的设计对焦速度偏慢	positive
现在价格很好	positive
给我的感觉有好也有不好	neutral
像紫边	neutral
开机慢大概秒以上窃以为还是的软件功底差了	negative
结果只有套机	neutral
至于蔡司的光学取景器	neutral
现在的屏幕裸露在外画面颗粒感较强	positive
的感光度在的时候也只能说勉强凑合看没有功能	positive
用转接要好很多但又没有了自动对焦色彩的话	positive
速控转盘的转动阻尼也发生了变化	neutral
话说玩过家的高清视频	neutral
机身内置的滤镜	positive
微距自动对焦较慢暂时还不够丰富的系统	negative
特别是我这样爱玩数码产品的	neutral
尤其是选择对焦点时需要同时用两个转盘来控制	neutral
如果没有视频	neutral
现在的高速储存卡速度很快	neutral
拍的时候不是说我转得太快	neutral
不太舒爽的是	neutral
但是便携性较差底感差	negative
的感光度在的时候也只能说勉强凑合看觉得电池续航能力很一般	negative
特别是一个用户的感受	neutral
是我最看中的	neutral
外拍时不显山不显水	neutral
也不错．	neutral
结论有些难下	neutral
变焦感觉有点慢哦画质没有什么出彩的地方	positive
稳定性照电子快门线和遥控器差的多现在的按键用起来不爽	positive
在室内拍颜色的饱和度都没看出来和有什么差异	neutral
机背部分	neutral
也可以在不断的使用中慢慢的明白自己到底喜欢拍什么	neutral
这个东东里面各项数据都有	neutral
的遮光罩为什么总是做的很松画面也惨不忍睹	positive
人脸识别识别率木有手机或者强最烦人的是不能全时手动	positive
真是屌丝遇到高帅富了	neutral
导致无法进行连续拍摄塑料感强	negative
高清摄像	positive
微距自动对焦较慢	negative
暗部对焦拉风箱机身塑料感强轻	positive
重量为克比克略重	neutral
的手感虽然少了的厚重感充电感觉不是很方便	positive
它的功能上的确有些不足顺便吐槽这几个新出的镜头	positive
配置一般格式连拍坑爹	negative
但可以让你另配	neutral
最不满意的也就对焦系统了但因为绿屏问题实在让我觉得膈应	negative
只有从机顶看觉得造型怪异些	negative
东芝高速卡我用了	neutral
我最不满意的是那个删除键	negative
不喜欢闪光灯的设计稍逊于单反的机械性能	negative
夜景画质很一般液晶屏无法关闭盲拍	negative
大光圈的虚化效果非常好	positive
放在一堆片子里你能明显感觉出不同来	neutral
其实跟着孩子跑也挺乐的	neutral
手柄也太小没有确实有点影响出片率	positive
手感操控性能画质已然全面落后对对焦点的明暗反差要求比较高	positive
快门声在体验时最想让我吐槽的就是它的快门声了不过感觉快门很涩	negative
想想以前在四川拍片	neutral
为什么照片这么小快门声音比我想象的大得多	negative
闪光灯就算了连续自动对焦的速度是最差的	negative
绝对没错	neutral
肩屏显示的信息很多就是紫边太严重	negative
感觉手柄还是略小特别是电池舱盖	positive
不知道它的除尘效果究竟如何	neutral
整体感觉就是一入门机的样子小五就成打酱油的	positive
发现很多跟论坛里的言论比较不同的地方	neutral
店内提供的组合	neutral
胶片和镜头都是可以自由选择的	neutral
快门按了万次	neutral
多块的东西做的跟几千块的一样	neutral
左侧的接口布局有了改变软件不太好使	negative
我之前买过柯达和	neutral
的工业设计到底怎么了系列的画质一般	negative
但便携机在图像质量上总是稍欠缺一点还有不能换镜头局限了拍摄题材对焦慢	positive
就只是怪的色彩只有一个外置接口	positive
没有那感觉和效果是脚底抹油也赶不上	negative
和的高感成像质量相比较而言就有些惨了	negative
自动中的自动根据焦距自动变化最低安全快门的设置显得十分贴心	positive
重启后不能手动	neutral
的镜头直径够大	positive
目前看感觉照片效果不如上周买的的松下没有闪光灯	negative
玩了半年就出掉了主要是边缘成像太差色散严重奥巴的/镜头也是个大块头	negative
夜景画质很一般压缩比有些点	negative
整体感觉就是一入门机的样子操作系统反映速度很慢	positive
艺术效果拍摄时拖尾严重	negative
感觉做的挺笨的	neutral
电池使用寿命短不过该机器已经设计了外接电源的线孔总体上给我的感觉这套系统对焦性能和差不多	negative
其他方面	neutral
一些精细控制选项给删除了	neutral
高感有说不如的	negative
严重时整个树枝都给你紫掉见图	neutral
高感就不要太奢求了比偏红偏假的色彩	negative
就是快门声音不怎么样但是阳光下的远景分辨率说句不好听的就像手机拍的一样而且紫边也不小	negative
特别是电池舱盖操作系统反映速度很慢	positive
常常能给我惊喜	neutral
以前很多人都说的机身差塑料感强	negative
就说下设计上的不足高感就不要太奢求了	positive
目前还没有配的既小巧又足够强大的闪光灯夜景画质很一般	positive
笔者迫不及待的想要感受新出的	neutral
以前很多人都说的机身差六的手动对焦环是假的是对焦环不是变焦环它的手动变焦环很爽	negative
但是长焦是外变焦但体积不小	positive
同样快门速度快门声在体验时最想让我吐槽的就是它的快门声了	positive
但实际试用发现对焦迟滞太严重亮度还是偏低	positive
首先是那个和啤酒瓶子盖一样的模式转盘但是像素比较低现在觉得我完全不需要高像素这点下面我会解释	positive
的手柄更适合手掌宽大的人	neutral
拍的小品	neutral
整体感觉就是一入门机的样子主要是最小光圈只到	positive
像素密度却是是万芯片的倍	neutral
阳光下也不弱	neutral
机器的工程塑料手感滑溜	positive
我现在很期待的移轴镜头	neutral
这叫还原真实	neutral
现场一位香港铁丝说这块屏幕就是三星某款出现偏绿的屏幕	neutral
低感时:	neutral
于是在有了之后	neutral
那玩意电老虎的极致	neutral
技术确实不精	neutral
色彩不够鲜艳可是定焦也太小气了	negative
但差距并没有想像的要大	neutral
另外各个按键也是袖珍级别的	neutral
用转接要好很多但又没有了自动对焦有时候界面操作都会有些许延时现象	negative
在熟悉机器操作的基础上	neutral
已经没有上一代产品的影子	neutral
的万像素全画幅传感器显得更加实用	positive
比新一点	neutral
它的功能上的确有些不足其次是那个主拨盘	positive
只是印证了由奢入俭难那句话	neutral
的高感画质相当不错	positive
产品说明上写得很清楚读写都是/	neutral
的画质使人眼前一亮	positive
关于材质虽然不是全金属的	neutral
可是定焦也太小气了主要是最小光圈只到	negative
无摄像功能操控缩水	negative
直接出片机内处理锐度过头了点最不满意的也就对焦系统了	positive
就是不太方便但色彩略差于	negative
屏幕用这么差的材料细节较多	positive
镜头突出很多感觉机身的自动白平衡有点问题	negative
我的就是最小的暗部噪点也清晰可见可是定焦也太小气了	positive
只是比弱一些	neutral
感觉拍小孩经常滞后	neutral
本人用相机最主要的场所有个	neutral
焦点实	positive
色彩标准模式	neutral
不过换镜头麻烦	neutral
也是如此的设计的工业设计真是倒退了三十年	positive
下面说个人总结的优缺点	neutral
有点浪费	neutral
都是出于画质	neutral
机身轻小后的缺陷装个都觉得头重脚轻电池不够用	negative
直接了	neutral
但它大面积增加了机身表面蒙皮	positive
写到这忽然发现两者结合就是个人感觉基本完美的微单	neutral
怎么说呢	neutral
不过个人觉得比较鸡肋	neutral
和开头的机器甚至开头的机器都不相符的塑料卡口对对焦点的明暗反差要求比较高	negative
外观上比较小巧时尚	positive
压缩比有些点肤色偏黄	negative
个人感觉一般	neutral
长宽比也改为了	neutral
我用一周处理测试	neutral
无摄像功能此头焦外绿边十分严重	positive
用上的快门把连拍速度提上去	neutral
镜头方面也有不足的地方录像按钮	positive
就只是怪的色彩试过边缘对焦	negative
没有任何提示和显示但色彩略差于	positive
相当棒的画质	positive
全黑色不张扬	neutral
但毕竟一分钱一分货	neutral
二选一	neutral
外盖分成了三部分对焦点的选择也略蛋疼	negative
稳定性照电子快门线和遥控器差的多肤色偏黄	negative
全黑的机身加上蔡司小蓝标	neutral
这头的对焦环手柄也太小	positive
最不满意的也就对焦系统了目前还没有配的既小巧又足够强大的闪光灯	negative
反差较小时镜头还会拉风箱拍出人物的皮肤较硬	positive
并且合焦精度非常高	positive
直接导致了握镜头的左手与抓手柄的右手在对焦操作时打架	neutral
哈哈	neutral
用过没多久就报低电量的	neutral
但对于我个人	neutral
外观变丑了	negative
按下键可以调出帮助页面	neutral
一些感受	neutral
就是色彩比较淡左侧的接口布局有了改变	negative
闪光灯没有闪光灯体积小	positive
但因为绿屏问题实在让我觉得膈应操作系统反映速度很慢	negative
它相机里电池自行放电由来已久底感差	positive
这得益于其采用的能够对色彩信息进行检测的区双层测光感应器	positive
但是真用起来	neutral
将机身和镜头安装好	neutral
个人觉得做工不如取景器切换时候会有遮挡	negative
感觉很不畅	neutral
因为用的少	neutral
	neutral
由于里面一片空白	neutral
第二天下午就拿到了	neutral
闪	neutral
边沿很烂	neutral
想升级的人	neutral
来给长期持币者说一下领会	neutral
片子发暗种种现象操控缩水	negative
色彩感觉没有原来的容易调整拍出来白蒙蒙的	negative
不过还是不爽	neutral
论坛上的大多朋友之所以很反感这部机器	neutral
感觉差距不大除非放大到	neutral
能玩微博啥的	neutral
理解单反	neutral
光学取景器聊胜于无当然这也许是白平衡的问题	negative
就是上面信息不全	neutral
另外高感也差很多对焦速度是目前单电系统软肋	negative
手柄突出部分和镜头对焦环之间的空间挤了点结果对焦和色彩让人失望	negative
长焦端光圈显得小了些机身轻小后的缺陷装个都觉得头重脚轻	negative
其实松下除了画质外/的快门大家都非常郁闷	negative
对焦速度还稍微跟不上在肩屏的信息显示量上也不够丰富	positive
低调沉稳	neutral
摆了一些样机	neutral
用过/系统的人绝对会受不了的触摸屏现在这个样子怎么看怎么像镜头长倒过来似的	positive
希望和大家分享一下	neutral
二对焦	neutral
多数场合可以用它取代那些沉甸甸的幅单反单电	neutral
感动就符合大多数人的审美观点	neutral
但是这颗镜头确实完全发挥了这颗万像素的全部记录能力	positive
总体上给我的感觉这套系统对焦性能和差不多自动对焦较慢	positive
我还是喜欢的	neutral
电子变焦	positive
就我的实际经验而言	neutral
特别是开关键	positive
我想用过的人应该有发言权吧	neutral
在暗处对焦边缘对焦点无力这个头的对焦性能并不好	negative
防抖是传统的	neutral
且目前售价也略高塑料感强	positive
对焦速度慢色彩不正及过渡不好	positive
电话验真伪	neutral
只有在按下模式转盘中央的锁定钮时模式转盘才可转动	neutral
完全没有发挥半透镜优势的对焦张/秒的连拍速度此头焦外绿边十分严重	negative
第一次冒泡发帖	neutral
缺点是体积略大机器内闪只有	negative
手柄也太小主要是最小光圈只到	negative
有时在长焦段会有拉风箱现象	negative
觉得电池续航能力很一般和开头的机器甚至开头的机器都不相符的塑料卡口	positive
当你被的在我的柜子里长期趴着一年用最多次	neutral
本人也是新手入门	neutral
转轮和八向键比较好用或许是因为我没有尝过摇杆的厉害吧	positive
面对一些荧光色的物品	neutral
手动对焦更慢一些重量重不少	negative
机内测光容易出错导致过曝它的功能上的确有些不足	positive
高感就不要太奢求了但便携机在图像质量上总是稍欠缺一点还有不能换镜头局限了拍摄题材	negative
本人并不是什么索黑或者索粉	neutral
暗部对焦比好很多	positive
不能说这颗系数转换前镜头会比的顶级镜头好	neutral
可能握持上不是太舒服看着取景器里的对焦点从模糊清晰模糊清晰的过程的确有砸机冲动	negative
其中	neutral
一关于画质	neutral
档的超级功能木有了感觉看不出噪点	negative
对焦叽叽的叫声让你觉得随时要坏目前价位还是高于的	negative
肩屏小了些	negative
尤其是的设置	neutral
直到周前才拿到	neutral
万象素的/相机显示屏	neutral
传说从按下快门到相片储存完毕	neutral
说明他的电子设计和技术较低端奥巴的机器握感都不好	negative
目前看感觉照片效果不如上周买的的松下操作够复杂的	positive
套头足够用	neutral
因为经常看到有人说的声音一塌糊涂但我宁可这样也不要糟糕的做工	positive
比的优点是防抖极强	positive
像素密度太密了四没有防抖	positive
考虑很久加上好不容易可以订到	neutral
密封不好等对焦点选择不是很方便	negative
这能够在一定程度上能够掩盖人物脸部皮肤的细微缺点	neutral
不过对焦点选择上虽然可以调成维方向选取	neutral
用料好	positive
拍出来的照片色调有些奇怪变焦感觉有点慢哦	positive
好吧	neutral
快门触感变深夜景手持真的很吃力	negative
这样在室内环境下拍宝宝不需要闪光灯了	neutral
秒不过也非常不错了	neutral
万像素	neutral
我如何劝说都不卖	neutral
为什么照片这么小和的高感成像质量相比较而言就有些惨了	negative
液晶屏上看还可以	positive
比还要轻便	neutral
这个不知道	neutral
没用过单反	neutral
仅此而言	neutral
当然这个缺点不是独有的	neutral
对焦/测光	neutral
就是给提意见您可以不必进来浪费时间	neutral
此头焦外绿边十分严重电池太渣	positive
一直很喜欢它的锐利度色泽与对焦速度	positive
实际上	neutral
外形	positive
对焦精度太差了就是对焦前先来回抽一下让人蛋疼	negative
比主流套头的手动变焦还是轻松不少	neutral
感光度只有超过了以后	neutral
上市后热门镜头时常缺货	neutral
像素密度太密了微距自动对焦较慢	negative
香港刚刚从日本拿到了几台	neutral
就是快门声音不怎么样为什么照片这么小	positive
不建议	neutral
目测对焦速度慢于对焦的确非常非常慢	positive
暂时还不够丰富的系统因为之前的的画质堪称垃圾	positive
原来因为这个功能强烈支持我拍买	neutral
可是定焦也太小气了但是屏幕实在不堪入目	positive
没有就是快门声音不怎么样	negative
还有配合/定焦可以勉强打鸟穷人打鸟最佳配置	neutral
可以说互相无法替代	neutral
而腾龙出片我个人感觉比较像一个数码记录图像的感光度在的时候也只能说勉强凑合看	positive
没有多次曝光功能	negative
现在的每台相机里面都有这样的白平衡	neutral
风景摄影表现一般另外高感也差很多	positive
而且像素多万	neutral
最近就入了以画质见长的	positive
完全没有发挥半透镜优势的对焦张/秒的连拍速度就是格式照片有点偏大本人用寸笔记本	positive
对焦速度还稍微跟不上致命的阳光下看不清屏幕	positive
拍出来绝对不能看	neutral
画面颗粒感较强	negative
那当我没说	neutral
但远处看去	neutral
电池不够用对焦框不会显示	negative
嵌入突出的手柄内	neutral
的完全可用	neutral
使用半个月下来	neutral
由于软件的优化	neutral
心里就痒痒的	neutral
在强光下的表现你照样想扔	neutral
一个能用一台入门级拍出好作品的人	neutral
说句实话	neutral
凡事无法尽善尽美	neutral
虽然没有那种探照灯般的耀眼	neutral
对焦准	positive
的新电池要充分的充电和放电用相机把电量耗干两到三次	neutral
价格也最高直出太差了	negative
直接出片机内处理锐度过头了点系列的画质一般	positive
很适合普通玩家的	neutral
整体感觉也还成	neutral
端容易近距跑焦	neutral
价钱不算低最烦人的是不能全时手动	positive
用过/系统的人绝对会受不了的触摸屏快门触感变深	positive
的机身依旧采用工程塑料机子太小太轻	negative
感觉还成吧	neutral
刚到手没什么拍	neutral
都拿在手中了才突然醒悟	neutral
但在大光圈长焦和闪光灯上还有不足但在大光圈长焦和闪光灯上还有不足	negative
六的手动对焦环是假的是对焦环不是变焦环它的手动变焦环很爽拍的好像蒙了一层雾	positive
重量	positive
夜景	neutral
手感操控性能画质已然全面落后在肩屏的信息显示量上也不够丰富	positive
快门打到尽然有重影让那些用的女士双臂平伸端着手感很差的克重物显得那么滑稽可笑	negative
但不比差	neutral
使用感受及几张随拍	neutral
笔记本屏幕看不出画质差异	neutral
配上镜头的暗角效果	neutral
一做工比扎实很多	positive
至于我严重关心的对焦	positive
所以让人感觉塑料感稍重的我一会不敢超过	negative
如果能忍受它缓慢的存储速度的话取景器切换时候会有遮挡	positive
室外风景偏蓝偏绿	neutral
没有多次曝光功能只有从机顶看觉得造型怪异些	negative
分辨率高	positive
导致无法进行连续拍摄软件不太好使	positive
就是快门声的变化	neutral
类似早几年的那么大小	neutral
目前价位还是高于的电池续航能力一般	positive
个人体验	neutral
画质优秀	positive
于是常常得在取景器和闪光灯之间换来换去	neutral
看到了非常多	neutral
反差较小时镜头还会拉风箱主要是因为色散控制不好的原因	positive
价格竞争力够	positive
妖孽的洞妖	neutral
虽然在强度上有些降低机身手感一般	negative
支持全幅加上有完整的感光元件机身镜头产品线	neutral
感受在对焦的时候有些犹豫色彩感觉没有原来的容易调整	negative
机不熟	neutral
完全足够	neutral
先说说优点	neutral
对于有人说它是塑料机身目前还没有配的既小巧又足够强大的闪光灯	negative
明显敌不过但驱动有点慢	negative
没有内闪	negative
值得一入啊	neutral
总结	neutral
机身按钮与功能选单	positive
设计这货的据说是个大师	neutral
不过感觉快门很涩光学取景器聊胜于无	positive
肤色偏黄肩屏小了些	negative
而且还取决于镜头	neutral
没什么用处外观既没有时尚	negative
我最不满意的是那个删除键色彩的话	positive
总体还可以吧	neutral
录像按钮感受在对焦的时候有些犹豫	positive
我也没资格说一定好于	neutral
如果一直按着键	neutral
因为原因有二	neutral
不小	neutral
手感操控性能画质已然全面落后对焦点不行啊	negative
这里放一并说说吧	neutral
或者用场景模式	neutral
现在多出来的锁定键做的太色彩灰暗	negative
但前提是图片	neutral
不过感觉快门很涩价格对我来说也贵了	positive
一是太小完全不像是消费专业级数码相机的水平有时候界面操作都会有些许延时现象	negative
高感很强大	positive
而且幅度不算小	neutral
它相机里电池自行放电由来已久个对焦框太大了	negative
图象完全看不清楚总体上给我的感觉这套系统对焦性能和差不多	negative
操控缩水附带的解软件解出来的效果非常差	positive
下面谈谈我个人对的小小感受	neutral
套餐￥的特价	neutral
新真是有点拿不出手	neutral
虽然我也是奔着高像素去的	neutral
我买了移动电源	neutral
档案算蛮小的这头的对焦环	negative
对焦叽叽的叫声让你觉得随时要坏	negative
毕竟细腻和色彩方面是基本上完成同价位的单反	positive
反差较小时镜头还会拉风箱带来的问题就是握持感	positive
画质方面	neutral
变焦感觉有点慢哦所以让人感觉塑料感稍重	negative
对焦速度还稍微跟不上但在自动对焦操控感受上还存在一定差距	negative
但速度不算很快	neutral
但终归还是麻烦	neutral
中央五个对焦点很暴力想问问为什么的照片这么小啊	positive
对焦很快	positive
不要去掉闪光灯的功能	neutral
而且使用速度狂慢我用的是苹果一体机晚上拍照比较吃力	positive
还有品控问题反光板污点门锐度偏低	positive
所以设计理念上不高明这是镜头太水的原因	negative
单反不是天天背的东西	neutral
我就想说	neutral
	neutral
外出旅游有阴影	neutral
觉得电池续航能力很一般当然这也许是白平衡的问题	negative
借用过朋友的金广角	neutral
我就买进了全市第一台套机元	neutral
开个玩笑	neutral
只用过	neutral
对于新手也是有很大帮助啊	neutral
闪光灯没有闪光灯没有闪光灯	negative
但是不用辅助灯也可以准确对焦	neutral
片子直出率立马翻身了	neutral
的手感虽然少了的厚重感塑料前脸仍然没有升级成合金材料	negative
其实松下除了画质外想问问为什么的照片这么小啊	negative
同不在一个档次	neutral
景深预览键没有的非常差	negative
低感	neutral
视野率取景器明亮	positive
虽然太暗也拉风箱现象	neutral
大家感觉如何	neutral
总结给人更多的是一种惊喜	neutral
本人不是托	neutral
不累	neutral
闪光灯就算了系列的画质一般	negative
机内测光容易出错导致过曝对焦真的没什么优势	negative
这个功能也是上新增的	neutral
把的卡口换成金属	neutral
测试使用拍照	neutral
同样快门速度	negative
操作够复杂的电子取景器有时滞	negative
机身塑料感十足	negative
顿时感动得不行能用	neutral
结果却是非常惊喜一直没用家的东西了可能少见多怪了	neutral
它的功能上的确有些不足总体上给我的感觉这套系统对焦性能和差不多	negative
带来的问题就是握持感	negative
有明显的区别	neutral
新增了短片自定义设定模式	neutral
为了匹配卡口	neutral
可能握持上不是太舒服问题是体积也没见小啊	negative
唯一一个觉得不好的就是	neutral
便宜好用的自动镜头少就是对焦前先来回抽一下让人蛋疼	negative
但色彩略差于手柄也太小	negative
最大的特点应该是完全移植了单反的卡口	neutral
一年半之前我拿到的时候	neutral
但是像素比较低现在觉得我完全不需要高像素这点下面我会解释个对焦框太大了	negative
最主要的还是便携性	neutral
这样才能充出其最高电量	neutral
这只镜头配合起来就有点问题对焦框不会显示	positive
的噪点属于比较大色斑我手持拍摄的出片率较低	positive
底部材料没有改进风景摄影表现一般	positive
有点遗憾	neutral
单单一个爽字哪能形容	neutral
长焦端没有防震但因为绿屏问题实在让我觉得膈应	positive
非常接近	neutral
类似抛光的样子	neutral
色彩灰暗这只镜头配合起来就有点问题	negative
还有就是确实存在严重的屏偏绿的问题存储速度慢	positive
塑料感强反差较小时镜头还会拉风箱	negative
最重要的除了长期习惯使用系统外	neutral
但这几天实拍	neutral
和的比似乎就少了点相位对焦点没有任何提示和显示	negative
如果能忍受它缓慢的存储速度的话充电感觉不是很方便	negative
那就无所谓了	neutral
不过手感一般对焦慢	positive
男士的大手更是局促了	neutral
中间有大概秒左右的呆滞时间	neutral
想全程手动都不可能了	neutral
包括的	neutral
采用了中央八向双十字	neutral
连续自动对焦的速度是最差的现在这个样子怎么看怎么像镜头长倒过来似的	negative
高速卡帮助不大总体上给我的感觉这套系统对焦性能和差不多	positive
继续宾得的传统	neutral
图像很硬手动对焦更慢一些	negative
由于一些功能按键的搬家	neutral
顺便说说自己的感受	neutral
我的第一感觉并不是很好	neutral
高速卡帮助不大	negative
快门延时稍长画面也惨不忍睹	positive
看来还是要上环	neutral
之前也摸过	neutral
最不满意的也就对焦系统了刚上手觉得操作特别困难	positive
我觉得的机身手感很不理想发现对焦速度有所降低	negative
终于选择入啦	neutral
快门声音真心不好听可是它的机械性能又实在是不好	positive
还是换了做备机	neutral
卡槽方便	neutral
确实看起来没帅气	neutral
边缘对焦还是比较容易拉风箱就是对焦前先来回抽一下让人蛋疼	negative
录像按钮	negative
有些当年的感觉	neutral
机身缝隙稍大炒冷饭	positive
我需要对焦	neutral
曝光正常	positive
不能总玩万像素的啊	neutral
翻转屏非常好用	positive
也觉得操作非常方便	positive
相反	neutral
坊间传闻	neutral
的工作电流小于	neutral
但应该是够用的	neutral
虽然没有这类机子专业	neutral
使用过和后的感受	neutral
感觉在如果只在电脑上看	neutral
现在多出来的锁定键做的太就说下设计上的不足	negative
这么密的小像素快门打到尽然有重影	negative
其实松下除了画质外在肩屏的信息显示量上也不够丰富	negative
顺便吐槽这几个新出的镜头肤色偏金黄色	negative
